30 100
CTTTGTTGAGTCGACTTTGTAACGGATAGA|GAGTGAGTCGACTTTGTAACGGATAGATTT
AGGGGCTCTGAGTCGACTTTGTTGAGTCGA|CGGCATACGAAGCCGTGAGTGAGTCGACTT
ATTGTGAGTCGACTTTGTAACGGATAGATT|ATTATCGGCCTCCGCTGAGCTCGTACGCAT
TAGATTTCAACCGATCTCATGATCTACGTA|GATTTCAAAACGGATAGATTTCAATCCGTC
CTGCCGGACTTCAAAAGCAAACAGCATATA|GACTTTGTAACGGATAGATTTCAAACGCGC
GGGGTAATCTTGAATGTACTTCAATAGGGA|TTAAACTTCTCCTGGTACACTGAGGTCGGA
GAGTCGACTTTGTAACGGATAGATTTCAAG|TAAATGCGTCTATCCGCCTCTAGTATCAAG
GTGTTGGTCCCCTGAGTCGACTTTGTAACG|ATTTCAAACTTAGTAATGTACTGCCGTTCC
CATTATATGAGTCGACTTTGTAACGGATAG|TCAATAACCAATTTAAAACGACCACAAGAC
GTGAGTCGACTTTGTAACGGATAGATTTCA|ATCGGCCTCCGCTGAGCTCGTACGCATAGA
TGAGTCGACTTTGTAACGGATAGATTTCAA|TTTGTAACGGATAGATTTCAACATTGTGCG
CCCTCCAAGCCGAATGCGCAGTGGCCACGC|TAACGGATAGATTTCAATACACCTCACTGT
AGATTTCAAAACGGATAGATTTCAATCCGT|TTTCAAAGTCTGTGAGAGCTCTACTGTGGC
TCCGAAGCATCTGCCCTCCCTCCAAGCCGA|TTGTTGAGTCGACTTTGTAACGGATAGATT
GAGTCGACTTTGTAACGGATAGATTTCAAA|TAATGTACTGCCGTTCCATCTCACATCCAC
GCCGGACTTCAAAAGCAAACAGCATATATC|CTTTGTAACGGATAGATTTCAAACGCGCTG
GACTTCAAAAGCAAACAGCATATATCACCA|GTAACGGATAGATTTCAAACGCGCTGAGTC
TGGAGTGTGTTCTGATTTTTAGAGACCGGC|ATCTCGACTCAGTGTTGGTCCCCTGAGTCG
AGCATAACTGCCGCGAATGCAATTGGGGTG|GATTTCAAGTATCAGCGATCACTTCTATCC
CGGCTGCCGGACTTCAAAAGCAAACAGCAT|GTCGACTTTGTAACGGATAGATTTCAAACG
AATGGTCTCCGAAGCATCTGCCCTCCCTCC|TATTCTGTTGTTGAGTCGACTTTGTAACGG
AGCCCTAGGGTTAATTTTTATATGAGTCGA|GGGCTCTGAGTCGACTTTGTTGAGTCGACT
AAGCCCTAGGGTTAATTTTTATATGAGTCG|GGGGCTCTGAGTCGACTTTGTTGAGTCGAC
TGTAACGGATAGATTTCAAAACGGATAGAT|AACGGATAGATTTCAAAGTCTGTGAGAGCT
ACGGATAGATTTCAAGTGGTTCGAGGGACG|CGCCTGAGCATTTACACAATATTTGTCGCG
CTGTAAAGGGCAACGAGGCGCTGCTCACGT|GATTTCAAGCCCTAGGGTTAATTTTTATAT
GGATAGATTTCAAGTGGTTCGAGGGACGCG|CCTGAGCATTTACACAATATTTGTCGCGTT
GGCTAGTACACCTTAACGCTCGTTCACTCG|CATGAGAATAGCCATCAAATTGTGAGTCGA
GTATAAGGCTAGTACACCTTAACGCTCGTT|TTGACCCATGAGAATAGCCATCAAATTGTG
AACGGATAGATTTCAAACTTAGTAATGTAC|AACACCACTTATTTGTTGAGTCGACTTTGT
CACTGAGGTCGGAGTAATGAGTCGACTTTG|GAAGCATCTGCCCTCCCTCCAAGCCGAATG
GCCTGAGCATTTACACAATATTTGTCGCGT|ACGGATAGATTTCAACCGATCTCATGATCT
ACACAATATTTGTCGCGTTTAAACTTCTCC|CAACCGATCTCATGATCTACGTACAAATGG
AGATTTCAAACTTAGTAATGTACTGCCGTT|CTTATTTGTTGAGTCGACTTTGTAACGGAT
CTGTTGTTGAGTCGACTTTGTAACGGATAG|TAAGGCTAGTACACCTTAACGCTCGTTCAC
CTGAGTCGACTTTGTAACGGATAGATTTCA|TTTAAATGCGTCTATCCGCCTCTAGTATCA
CAATTTAAAACGACCACAAGACAGCTGAGT|CTACCTAACCTGATGCCGACATCACACCCG
TTTGTTGAGTCGACTTTGTAACGGATAGAT|TGTCTCCTGTAAAGGGCAACGAGGCGCTGC
AATATTTGTCGCGTTTAAACTTCTCCTGGT|CGATCTCATGATCTACGTACAAATGGTCTC
CAACGAGGCGCTGCTCACGTAAAGAGATAG|CCTAGGGTTAATTTTTATATGAGTCGACTT
CAAGTATCAGCGATCACTTCTATCCCAAAC|CAAGTCCTAGATACTCGCTATTTGTGCGCC
ACTTTGTAACGGATAGATTTCAAGAGTCGA|AGGGCAACGAGGCGCTGCTCACGTAAAGAG
GAGTCGACTTTGTAACGGATAGATTTCAAG|CTGTAAAGGGCAACGAGGCGCTGCTCACGT
CCCAAACATTGCAGGTTTACAACTGCAGTA|GTGCGCCTTCGCCGAAGCCATTTTATGAGC
AGAGTCGACTTTGTAACGGATAGATTTCAA|GTAAAGAGATAGATGCGCCTGAGCATTTAC
GATTTCAAGTGGTTCGAGGGACGCGGGGTA|GCATTTACACAATATTTGTCGCGTTTAAAC
ATTTGTCGCGTTTAAACTTCTCCTGGTACA|TCTCATGATCTACGTACAAATGGTCTCCGA
CTTTGTAACGGATAGATTTCAACCGATCTC|TTGTAACGGATAGATTTCAAAACGGATAGA
CAAGTGGTTCGAGGGACGCGGGGTAATCTT|TACACAATATTTGTCGCGTTTAAACTTCTC
AAGCAAACAGCATATATCACCAGAATTCGC|TAGATTTCAAACGCGCTGAGTCGACTTTGT
TGAGAATAGCCATCAAATTGTGAGTCGACT|TACAACTGCAGTACTTATTATCGGCCTCCG
CAAATTGTGAGTCGACTTTGTAACGGATAG|CTTATTATCGGCCTCCGCTGAGCTCGTACG
TCGACTTTGTAACGGATAGATTTCAAAGTC|ACTATCGGCGTGTGAAAAGCATAACTGCCG
CGTTGAGTCGACTTTGTAACGGATAGATTT|GACTTTGTAACGGATAGATTTCAACATTGT
CCTAGGGTTAATTTTTATATGAGTCGACTT|CTCTGAGTCGACTTTGTTGAGTCGACTTTG
ACAATATTTGTCGCGTTTAAACTTCTCCTG|ACCGATCTCATGATCTACGTACAAATGGTC
TGCCGGACTTCAAAAGCAAACAGCATATAT|ACTTTGTAACGGATAGATTTCAAACGCGCT
TCGACTTTGTAACGGATAGATTTCAAGCCC|AGCCGAATGCGCAGTGGCCACGCAGGGGCT
GGCCACGCAGGGGCTCTGAGTCGACTTTGT|CTCACTGTCGGCATACGAAGCCGTGAGTGA
TGTAAAGGGCAACGAGGCGCTGCTCACGTA|ATTTCAAGCCCTAGGGTTAATTTTTATATG
TTTCATACCAAAGCGTACTTGTCTCCTGTA|TAATGAGTCGACTTTGTAACGGATAGATTT
TCTGATTTTTAGAGACCGGCTGCCGGACTT|AGTGTTGGTCCCCTGAGTCGACTTTGTAAC
TGAGTCGACTTTGTAACGGATAGATTTCAA|CAAACGGCCCAGAGCGCATGCGCCATTAAC
ATTGTGCGCTGCTGAGTCGACTTTGTAACG|TGTCTAAACGATTTAAATGCGTCTATCCGC
AGTGAGTCGACTTTGTAACGGATAGATTTC|GCTGGTACTATCGGCGTGTGAAAAGCATAA
GACTTTGTAACGGATAGATTTCAACATTGT|TCCGCTGAGCTCGTACGCATAGATATGTCT
ATGTACTTCAATAGGGACTTTCATACCAAA|GGTACACTGAGGTCGGAGTAATGAGTCGAC
TAACCAATTTAAAACGACCACAAGACAGCT|GTCGCTACCTAACCTGATGCCGACATCACA
CAACCGATCTCATGATCTACGTACAAATGG|AAACGGATAGATTTCAATCCGTCAATATTC
CAAGAGTCGACTTTGTAACGGATAGATTTC|ACGTAAAGAGATAGATGCGCCTGAGCATTT
GTACACCTTAACGCTCGTTCACTCGTTGAG|GAATAGCCATCAAATTGTGAGTCGACTTTG
AATCTTGAATGTACTTCAATAGGGACTTTC|CTTCTCCTGGTACACTGAGGTCGGAGTAAT
TGAGTCGACTTTGTAACGGATAGATTTCAA|ACCCGCAGGCATGTAACACCACTTATTTGT
AGAATTCGCTCGCGCCTTCTCCATTATATG|CGACTTTGTAACGGATAGATTTCAATAACC
AGGGACTTTCATACCAAAGCGTACTTGTCT|TCGGAGTAATGAGTCGACTTTGTAACGGAT
CGCGCCTTCTCCATTATATGAGTCGACTTT|ACGGATAGATTTCAATAACCAATTTAAAAC
GTTCTGATTTTTAGAGACCGGCTGCCGGAC|TCAGTGTTGGTCCCCTGAGTCGACTTTGTA
AATGTACTTCAATAGGGACTTTCATACCAA|TGGTACACTGAGGTCGGAGTAATGAGTCGA
TCCGTCAATATTCTGTTGTTGAGTCGACTT|GTGGCAACTGTATAAGGCTAGTACACCTTA
ATATTCTGTTGTTGAGTCGACTTTGTAACG|CTGTATAAGGCTAGTACACCTTAACGCTCG
GCCCTCCCTCCAAGCCGAATGCGCAGTGGC|CTTTGTAACGGATAGATTTCAATACACCTC
AACTTAGTAATGTACTGCCGTTCCATCTCA|TTGAGTCGACTTTGTAACGGATAGATTTCA
TTGTAACGGATAGATTTCAAGCCCTAGGGT|ATGCGCAGTGGCCACGCAGGGGCTCTGAGT
GCCATCAAATTGTGAGTCGACTTTGTAACG|CAGTACTTATTATCGGCCTCCGCTGAGCTC
CACCACTTATTTGTTGAGTCGACTTTGTAA|AAGCGTACTTGTCTCCTGTAAAGGGCAACG
CAGGCATGTAACACCACTTATTTGTTGAGT|CTTTCATACCAAAGCGTACTTGTCTCCTGT
TAGATTTCAAGTGGTTCGAGGGACGCGGGG|GAGCATTTACACAATATTTGTCGCGTTTAA
ATAGATTTCAAAACGGATAGATTTCAATCC|GATTTCAAAGTCTGTGAGAGCTCTACTGTG
ATCGGCGTGTGAAAAGCATAACTGCCGCGA|CTTTGTAACGGATAGATTTCAAGTATCAGC
CATCTGCCCTCCCTCCAAGCCGAATGCGCA|GTCGACTTTGTAACGGATAGATTTCAATAC
CTGAGGTCGGAGTAATGAGTCGACTTTGTA|AGCATCTGCCCTCCCTCCAAGCCGAATGCG
GATCTACGTACAAATGGTCTCCGAAGCATC|TCAATCCGTCAATATTCTGTTGTTGAGTCG
GAGTCGACTTTGTAACGGATAGATTTCAAT|GTACACCTTAACGCTCGTTCACTCGTTGAG
TTGCAGGTTTACAACTGCAGTACTTATTAT|TCGCCGAAGCCATTTTATGAGCAACAAGAC
TAGAGACCGGCTGCCGGACTTCAAAAGCAA|CCCCTGAGTCGACTTTGTAACGGATAGATT
TTTCAAAGTCTGTGAGAGCTCTACTGTGGC|ATAACTGCCGCGAATGCAATTGGGGTGTAT
ACCAAAGCGTACTTGTCTCCTGTAAAGGGC|GTCGACTTTGTAACGGATAGATTTCAAGCC
TCAATACACCTCACTGTCGGCATACGAAGC|TTGAGTCGACTTTGTAACGGATAGATTTCA
GGTCGGAGTAATGAGTCGACTTTGTAACGG|TCTGCCCTCCCTCCAAGCCGAATGCGCAGT
CAATACACCTCACTGTCGGCATACGAAGCC|TGAGTCGACTTTGTAACGGATAGATTTCAA
ACCTAACCTGATGCCGACATCACACCCGCA|GGTAATCTTGAATGTACTTCAATAGGGACT
GATTTCAATCCGTCAATATTCTGTTGTTGA|GCTCTACTGTGGCAACTGTATAAGGCTAGT
CTCATGATCTACGTACAAATGGTCTCCGAA|AGATTTCAATCCGTCAATATTCTGTTGTTG
GGATAGATTTCAACTGTCGTAATCTCGACT|CAAGACAGCTGAGTCGACTTTGTAACGGAT
TCGACTTTGTAACGGATAGATTTCAACATT|CCTCCGCTGAGCTCGTACGCATAGATATGT
CAATATTTGTCGCGTTTAAACTTCTCCTGG|CCGATCTCATGATCTACGTACAAATGGTCT
AACATTGCAGGTTTACAACTGCAGTACTTA|GCCTTCGCCGAAGCCATTTTATGAGCAACA
CGCTGCTGAGTCGACTTTGTAACGGATAGA|AACGATTTAAATGCGTCTATCCGCCTCTAG
GTACTGCCGTTCCATCTCACATCCACATCG|TTGTAACGGATAGATTTCAAGAGTCGACTT
TGAGTCGACTTTGTTGAGTCGACTTTGTAA|GAAGCCGTGAGTGAGTCGACTTTGTAACGG
ATAGATTTCAACGCGCTGGTACTATCGGCG|AACATTGTGCGCTGCTGAGTCGACTTTGTA
CAAGCCGAATGCGCAGTGGCCACGCAGGGG|GATAGATTTCAATACACCTCACTGTCGGCA
ATTTCAACATTGTGCGCTGCTGAGTCGACT|CATAGATATGTCTAAACGATTTAAATGCGT
GATGCGCCTGAGCATTTACACAATATTTGT|TTGTAACGGATAGATTTCAACCGATCTCAT
GATTTCAAGAGTCGACTTTGTAACGGATAG|TGCTCACGTAAAGAGATAGATGCGCCTGAG
ATTTCAACCGATCTCATGATCTACGTACAA|TTCAAAACGGATAGATTTCAATCCGTCAAT
GAATTCGCTCGCGCCTTCTCCATTATATGA|GACTTTGTAACGGATAGATTTCAATAACCA
ACCTCACTGTCGGCATACGAAGCCGTGAGT|GACTTTGTAACGGATAGATTTCAACGCGCT
TTCCATCTCACATCCACATCGTCAAACGGC|ATAGATTTCAAGAGTCGACTTTGTAACGGA
TCGACTTTGTAACGGATAGATTTCAATAAC|CGGCCCAGAGCGCATGCGCCATTAACGTCG
CAAACATTGCAGGTTTACAACTGCAGTACT|GCGCCTTCGCCGAAGCCATTTTATGAGCAA
ACACCCGCAGGCATGTAACACCACTTATTT|ATAGGGACTTTCATACCAAAGCGTACTTGT
CTTGAATGTACTTCAATAGGGACTTTCATA|CTCCTGGTACACTGAGGTCGGAGTAATGAG
GTAAAGAGATAGATGCGCCTGAGCATTTAC|ATGAGTCGACTTTGTAACGGATAGATTTCA
CGTCGCTACCTAACCTGATGCCGACATCAC|GACGCGGGGTAATCTTGAATGTACTTCAAT
TTTCAAACTTAGTAATGTACTGCCGTTCCA|ATTTGTTGAGTCGACTTTGTAACGGATAGA
TTCAAAACGGATAGATTTCAATCCGTCAAT|AAAGTCTGTGAGAGCTCTACTGTGGCAACT
AGAGCGCATGCGCCATTAACGTCGCTACCT|GATTTCAAGTGGTTCGAGGGACGCGGGGTA
TCCCAAACATTGCAGGTTTACAACTGCAGT|TGTGCGCCTTCGCCGAAGCCATTTTATGAG
GACCCATGAGAATAGCCATCAAATTGTGAG|CAGGTTTACAACTGCAGTACTTATTATCGG
ATGAGTCGACTTTGTAACGGATAGATTTCA|CTCCAAGCCGAATGCGCAGTGGCCACGCAG
GCCGCGAATGCAATTGGGGTGTATAACATT|TATCAGCGATCACTTCTATCCCAAACATTG
TTTCAAGTGGTTCGAGGGACGCGGGGTAAT|ATTTACACAATATTTGTCGCGTTTAAACTT
GACTTTGTAACGGATAGATTTCAATACACC|CCTTAACGCTCGTTCACTCGTTGAGTCGAC
ACTTTGTAACGGATAGATTTCAAGTGGTTC|GATAGATGCGCCTGAGCATTTACACAATAT
CGTACAAATGGTCTCCGAAGCATCTGCCCT|CGTCAATATTCTGTTGTTGAGTCGACTTTG
TGTGAAAAGCATAACTGCCGCGAATGCAAT|ACGGATAGATTTCAAGTATCAGCGATCACT
ATTTCAAGTATCAGCGATCACTTCTATCCC|GTATCAAGTCCTAGATACTCGCTATTTGTG
AAAACGGATAGATTTCAATCCGTCAATATT|GTCTGTGAGAGCTCTACTGTGGCAACTGTA
AGTGTTGGTCCCCTGAGTCGACTTTGTAAC|GATTTCAAACTTAGTAATGTACTGCCGTTC
GATAGATTTCAACCGATCTCATGATCTACG|TAGATTTCAAAACGGATAGATTTCAATCCG
TAGATTTCAAACGCGCTGAGTCGACTTTGT|CTCACATCCACATCGTCAAACGGCCCAGAG
TGTCTCCTGTAAAGGGCAACGAGGCGCTGC|CGGATAGATTTCAAGCCCTAGGGTTAATTT
TCTCCTGGTACACTGAGGTCGGAGTAATGA|AATGGTCTCCGAAGCATCTGCCCTCCCTCC
CGTTTAAACTTCTCCTGGTACACTGAGGTC|TCTACGTACAAATGGTCTCCGAAGCATCTG
CTAGGGTTAATTTTTATATGAGTCGACTTT|TCTGAGTCGACTTTGTTGAGTCGACTTTGT
GCGCAGTGGCCACGCAGGGGCTCTGAGTCG|AATACACCTCACTGTCGGCATACGAAGCCG
TTCGAGGGACGCGGGGTAATCTTGAATGTA|TATTTGTCGCGTTTAAACTTCTCCTGGTAC
TGCCGCGAATGCAATTGGGGTGTATAACAT|GTATCAGCGATCACTTCTATCCCAAACATT
TGCTCACGTAAAGAGATAGATGCGCCTGAG|TTTTTATATGAGTCGACTTTGTAACGGATA
CACTTCTATCCCAAACATTGCAGGTTTACA|TCGCTATTTGTGCGCCTTCGCCGAAGCCAT
TTTTTATATGAGTCGACTTTGTAACGGATA|CTTTGTTGAGTCGACTTTGTAACGGATAGA
TGACCCATGAGAATAGCCATCAAATTGTGA|GCAGGTTTACAACTGCAGTACTTATTATCG
GCTGCCGGACTTCAAAAGCAAACAGCATAT|CGACTTTGTAACGGATAGATTTCAAACGCG
GTCGGCATACGAAGCCGTGAGTGAGTCGAC|AACGGATAGATTTCAACGCGCTGGTACTAT
ACTTTGTAACGGATAGATTTCAAGTATCAG|CGTCTATCCGCCTCTAGTATCAAGTCCTAG
GGAGTAATGAGTCGACTTTGTAACGGATAG|CCCTCCCTCCAAGCCGAATGCGCAGTGGCC
TTAACGCTCGTTCACTCGTTGAGTCGACTT|CATCAAATTGTGAGTCGACTTTGTAACGGA
TCGACTTTGTAACGGATAGATTTCAACCGA|GACTTTGTAACGGATAGATTTCAAAACGGA
ATTGCAGGTTTACAACTGCAGTACTTATTA|TTCGCCGAAGCCATTTTATGAGCAACAAGA
CGACTTTGTAACGGATAGATTTCAAAGTCT|CTATCGGCGTGTGAAAAGCATAACTGCCGC
CTGTGAGAGCTCTACTGTGGCAACTGTATA|GCGAATGCAATTGGGGTGTATAACATTGAC
AACCTGATGCCGACATCACACCCGCAGGCA|ATCTTGAATGTACTTCAATAGGGACTTTCA
TATGAGTCGACTTTGTAACGGATAGATTTC|TGAGTCGACTTTGTAACGGATAGATTTCAA
ATACACCTCACTGTCGGCATACGAAGCCGT|AGTCGACTTTGTAACGGATAGATTTCAACG
GATGCCGACATCACACCCGCAGGCATGTAA|GAATGTACTTCAATAGGGACTTTCATACCA
TTCTGATTTTTAGAGACCGGCTGCCGGACT|CAGTGTTGGTCCCCTGAGTCGACTTTGTAA
AATAGCCATCAAATTGTGAGTCGACTTTGT|ACTGCAGTACTTATTATCGGCCTCCGCTGA
AATAACCAATTTAAAACGACCACAAGACAG|ACGTCGCTACCTAACCTGATGCCGACATCA
GTGAGTGAGTCGACTTTGTAACGGATAGAT|CGCGCTGGTACTATCGGCGTGTGAAAAGCA
GACTTTGTAACGGATAGATTTCAACCGATC|CTTTGTAACGGATAGATTTCAAAACGGATA
GTACACTGAGGTCGGAGTAATGAGTCGACT|TCCGAAGCATCTGCCCTCCCTCCAAGCCGA
TCAAGTATCAGCGATCACTTCTATCCCAAA|TCAAGTCCTAGATACTCGCTATTTGTGCGC
TGTTGGTCCCCTGAGTCGACTTTGTAACGG|TTTCAAACTTAGTAATGTACTGCCGTTCCA
TAATCTTGAATGTACTTCAATAGGGACTTT|ACTTCTCCTGGTACACTGAGGTCGGAGTAA
GATAGATTTCAACTGTCGTAATCTCGACTC|AAGACAGCTGAGTCGACTTTGTAACGGATA
GTCGACTTTGTAACGGATAGATTTCAAGTA|AATGCGTCTATCCGCCTCTAGTATCAAGTC
GTTCGAGGGACGCGGGGTAATCTTGAATGT|ATATTTGTCGCGTTTAAACTTCTCCTGGTA
GGTCTCCGAAGCATCTGCCCTCCCTCCAAG|TCTGTTGTTGAGTCGACTTTGTAACGGATA
TACTTCAATAGGGACTTTCATACCAAAGCG|ACACTGAGGTCGGAGTAATGAGTCGACTTT
AACGGCCCAGAGCGCATGCGCCATTAACGT|AACGGATAGATTTCAAGTGGTTCGAGGGAC
CATCGTCAAACGGCCCAGAGCGCATGCGCC|GACTTTGTAACGGATAGATTTCAAGTGGTT
TCGACTTTGTAACGGATAGATTTCAACGCG|TAACGGATAGATTTCAACATTGTGCGCTGC
CAACGCGCTGGTACTATCGGCGTGTGAAAA|GCGCTGCTGAGTCGACTTTGTAACGGATAG
ACGGATAGATTTCAAACTTAGTAATGTACT|ACACCACTTATTTGTTGAGTCGACTTTGTA
GACTTTCATACCAAAGCGTACTTGTCTCCT|GAGTAATGAGTCGACTTTGTAACGGATAGA
TAGATTTCAATAACCAATTTAAAACGACCA|CGCCATTAACGTCGCTACCTAACCTGATGC
TACACCTCACTGTCGGCATACGAAGCCGTG|GTCGACTTTGTAACGGATAGATTTCAACGC
CGCAGGCATGTAACACCACTTATTTGTTGA|GACTTTCATACCAAAGCGTACTTGTCTCCT
GACTTTGTAACGGATAGATTTCAAACTTAG|AGGCATGTAACACCACTTATTTGTTGAGTC
GTACTTCAATAGGGACTTTCATACCAAAGC|TACACTGAGGTCGGAGTAATGAGTCGACTT
GTGGCAACTGTATAAGGCTAGTACACCTTA|TGTATAACATTGACCCATGAGAATAGCCAT
ACGCTCGTTCACTCGTTGAGTCGACTTTGT|CAAATTGTGAGTCGACTTTGTAACGGATAG
CTGCCGTTCCATCTCACATCCACATCGTCA|TAACGGATAGATTTCAAGAGTCGACTTTGT
TGCAGTACTTATTATCGGCCTCCGCTGAGC|TATGAGCAACAAGACACAGTTCGGTGTCCC
CTCCGAAGCATCTGCCCTCCCTCCAAGCCG|GTTGTTGAGTCGACTTTGTAACGGATAGAT
CGACTTTGTAACGGATAGATTTCAAACGCG|GTACTGCCGTTCCATCTCACATCCACATCG
ATAGATTTCAAGTATCAGCGATCACTTCTA|TCTAGTATCAAGTCCTAGATACTCGCTATT
CTGTGGCAACTGTATAAGGCTAGTACACCT|GGTGTATAACATTGACCCATGAGAATAGCC
TGAATGTACTTCAATAGGGACTTTCATACC|CCTGGTACACTGAGGTCGGAGTAATGAGTC
AAGCCGTGAGTGAGTCGACTTTGTAACGGA|TTCAACGCGCTGGTACTATCGGCGTGTGAA
GTAACGGATAGATTTCAAGCCCTAGGGTTA|GCGCAGTGGCCACGCAGGGGCTCTGAGTCG
AAACGACCACAAGACAGCTGAGTCGACTTT|ACCTGATGCCGACATCACACCCGCAGGCAT
CCGACATCACACCCGCAGGCATGTAACACC|GTACTTCAATAGGGACTTTCATACCAAAGC
CGACTTTGTAACGGATAGATTTCAATACAC|ACCTTAACGCTCGTTCACTCGTTGAGTCGA
ACACCTTAACGCTCGTTCACTCGTTGAGTC|ATAGCCATCAAATTGTGAGTCGACTTTGTA
CCATTAACGTCGCTACCTAACCTGATGCCG|TTCGAGGGACGCGGGGTAATCTTGAATGTA
TTTCAAGCCCTAGGGTTAATTTTTATATGA|CGCAGGGGCTCTGAGTCGACTTTGTTGAGT
TAGATGCGCCTGAGCATTTACACAATATTT|CTTTGTAACGGATAGATTTCAACCGATCTC
GACCACAAGACAGCTGAGTCGACTTTGTAA|GATGCCGACATCACACCCGCAGGCATGTAA
AGTCGACTTTGTAACGGATAGATTTCAATA|AACGGCCCAGAGCGCATGCGCCATTAACGT
GCAGGGGCTCTGAGTCGACTTTGTTGAGTC|GTCGGCATACGAAGCCGTGAGTGAGTCGAC
ACCAATTTAAAACGACCACAAGACAGCTGA|CGCTACCTAACCTGATGCCGACATCACACC
ACGCGCTGGTACTATCGGCGTGTGAAAAGC|GCTGCTGAGTCGACTTTGTAACGGATAGAT
GCGCCTGAGCATTTACACAATATTTGTCGC|TAACGGATAGATTTCAACCGATCTCATGAT
TGTAACGGATAGATTTCAAACTTAGTAATG|TGTAACACCACTTATTTGTTGAGTCGACTT
CTTTCATACCAAAGCGTACTTGTCTCCTGT|GTAATGAGTCGACTTTGTAACGGATAGATT
ATTTCAAACTTAGTAATGTACTGCCGTTCC|TATTTGTTGAGTCGACTTTGTAACGGATAG
GATTTCAATAACCAATTTAAAACGACCACA|CCATTAACGTCGCTACCTAACCTGATGCCG
GAGCATTTACACAATATTTGTCGCGTTTAA|ATAGATTTCAACCGATCTCATGATCTACGT
GACAGCTGAGTCGACTTTGTAACGGATAGA|CATCACACCCGCAGGCATGTAACACCACTT
GCAACTGTATAAGGCTAGTACACCTTAACG|ATAACATTGACCCATGAGAATAGCCATCAA
CGCTGAGTCGACTTTGTAACGGATAGATTT|CGTCAAACGGCCCAGAGCGCATGCGCCATT
GCAATTGGGGTGTATAACATTGACCCATGA|TCACTTCTATCCCAAACATTGCAGGTTTAC
CTTTGTAACGGATAGATTTCAAACTTAGTA|GCATGTAACACCACTTATTTGTTGAGTCGA
ATTTTTAGAGACCGGCTGCCGGACTTCAAA|TTGGTCCCCTGAGTCGACTTTGTAACGGAT
GATAGATTTCAAGTATCAGCGATCACTTCT|CTCTAGTATCAAGTCCTAGATACTCGCTAT
CAGAATTCGCTCGCGCCTTCTCCATTATAT|TCGACTTTGTAACGGATAGATTTCAATAAC
TCAGCGATCACTTCTATCCCAAACATTGCA|CTAGATACTCGCTATTTGTGCGCCTTCGCC
TGTATAAGGCTAGTACACCTTAACGCTCGT|ATTGACCCATGAGAATAGCCATCAAATTGT
TGCAATTGGGGTGTATAACATTGACCCATG|ATCACTTCTATCCCAAACATTGCAGGTTTA
ATGGTCTCCGAAGCATCTGCCCTCCCTCCA|ATTCTGTTGTTGAGTCGACTTTGTAACGGA
CGAGGCGCTGCTCACGTAAAGAGATAGATG|AGGGTTAATTTTTATATGAGTCGACTTTGT
GTCGACTTTGTAACGGATAGATTTCAAGAG|GTAAAGGGCAACGAGGCGCTGCTCACGTAA
ACTTAGTAATGTACTGCCGTTCCATCTCAC|TGAGTCGACTTTGTAACGGATAGATTTCAA
AAGAGTCGACTTTGTAACGGATAGATTTCA|CGTAAAGAGATAGATGCGCCTGAGCATTTA
AGGGACGCGGGGTAATCTTGAATGTACTTC|TGTCGCGTTTAAACTTCTCCTGGTACACTG
ATTCTGTTGTTGAGTCGACTTTGTAACGGA|GTATAAGGCTAGTACACCTTAACGCTCGTT
AAACTTAGTAATGTACTGCCGTTCCATCTC|GTTGAGTCGACTTTGTAACGGATAGATTTC
TGAGTCGACTTTGTAACGGATAGATTTCAA|AGTCGACTTTGTAACGGATAGATTTCAAAA
TGAGTCGACTTTGTAACGGATAGATTTCAA|AGTACACCTTAACGCTCGTTCACTCGTTGA
CAGGTTTACAACTGCAGTACTTATTATCGG|CCGAAGCCATTTTATGAGCAACAAGACACA
TAACGGATAGATTTCAAGAGTCGACTTTGT|ACGAGGCGCTGCTCACGTAAAGAGATAGAT
CGGATAGATTTCAAACTTAGTAATGTACTG|CACCACTTATTTGTTGAGTCGACTTTGTAA
AGCGCATGCGCCATTAACGTCGCTACCTAA|TTTCAAGTGGTTCGAGGGACGCGGGGTAAT
CAAGACAGCTGAGTCGACTTTGTAACGGAT|CGACATCACACCCGCAGGCATGTAACACCA
GGCGCTGCTCACGTAAAGAGATAGATGCGC|GTTAATTTTTATATGAGTCGACTTTGTAAC
GATAGATTTCAAAGTCTGTGAGAGCTCTAC|AAAAGCATAACTGCCGCGAATGCAATTGGG
CACCTTAACGCTCGTTCACTCGTTGAGTCG|TAGCCATCAAATTGTGAGTCGACTTTGTAA
CTGCCCTCCCTCCAAGCCGAATGCGCAGTG|GACTTTGTAACGGATAGATTTCAATACACC
CTTAGTAATGTACTGCCGTTCCATCTCACA|GAGTCGACTTTGTAACGGATAGATTTCAAG
AACGACCACAAGACAGCTGAGTCGACTTTG|CCTGATGCCGACATCACACCCGCAGGCATG
GCCCTAGGGTTAATTTTTATATGAGTCGAC|GGCTCTGAGTCGACTTTGTTGAGTCGACTT
TCGACTTTGTAACGGATAGATTTCAAGAGT|TAAAGGGCAACGAGGCGCTGCTCACGTAAA
ATCCACATCGTCAAACGGCCCAGAGCGCAT|GAGTCGACTTTGTAACGGATAGATTTCAAG
CAGCATATATCACCAGAATTCGCTCGCGCC|CAAACGCGCTGAGTCGACTTTGTAACGGAT
AGATAGATGCGCCTGAGCATTTACACAATA|CGACTTTGTAACGGATAGATTTCAACCGAT
AGTGGCCACGCAGGGGCTCTGAGTCGACTT|CACCTCACTGTCGGCATACGAAGCCGTGAG
AGCCGTGAGTGAGTCGACTTTGTAACGGAT|TCAACGCGCTGGTACTATCGGCGTGTGAAA
CCGATCTCATGATCTACGTACAAATGGTCT|CGGATAGATTTCAATCCGTCAATATTCTGT
CAAATGGTCTCCGAAGCATCTGCCCTCCCT|AATATTCTGTTGTTGAGTCGACTTTGTAAC
GGATAGATTTCAATAACCAATTTAAAACGA|ATGCGCCATTAACGTCGCTACCTAACCTGA
TGAGGTCGGAGTAATGAGTCGACTTTGTAA|GCATCTGCCCTCCCTCCAAGCCGAATGCGC
ACTTGTCTCCTGTAAAGGGCAACGAGGCGC|TAACGGATAGATTTCAAGCCCTAGGGTTAA
TCAAGAGTCGACTTTGTAACGGATAGATTT|CACGTAAAGAGATAGATGCGCCTGAGCATT
GTAACGGATAGATTTCAAAACGGATAGATT|ACGGATAGATTTCAAAGTCTGTGAGAGCTC
ACGGATAGATTTCAAGCCCTAGGGTTAATT|CAGTGGCCACGCAGGGGCTCTGAGTCGACT
ATTTCAAAGTCTGTGAGAGCTCTACTGTGG|CATAACTGCCGCGAATGCAATTGGGGTGTA
GCGTGTGAAAAGCATAACTGCCGCGAATGC|GTAACGGATAGATTTCAAGTATCAGCGATC
GACTTTGTAACGGATAGATTTCAAGTGGTT|AGATAGATGCGCCTGAGCATTTACACAATA
CACACCCGCAGGCATGTAACACCACTTATT|AATAGGGACTTTCATACCAAAGCGTACTTG
TAACGGATAGATTTCAACATTGTGCGCTGC|AGCTCGTACGCATAGATATGTCTAAACGAT
TTCTATCCCAAACATTGCAGGTTTACAACT|CTATTTGTGCGCCTTCGCCGAAGCCATTTT
TCTTGAATGTACTTCAATAGGGACTTTCAT|TCTCCTGGTACACTGAGGTCGGAGTAATGA
ATATGAGTCGACTTTGTAACGGATAGATTT|TAACCAATTTAAAACGACCACAAGACAGCT
AATTGTGAGTCGACTTTGTAACGGATAGAT|TATTATCGGCCTCCGCTGAGCTCGTACGCA
CGTCAATATTCTGTTGTTGAGTCGACTTTG|GGCAACTGTATAAGGCTAGTACACCTTAAC
GACTTTGTAACGGATAGATTTCAAGTATCA|GCGTCTATCCGCCTCTAGTATCAAGTCCTA
TCGGCGTGTGAAAAGCATAACTGCCGCGAA|TTTGTAACGGATAGATTTCAAGTATCAGCG
CTTTGTAACGGATAGATTTCAAGTATCAGC|GTCTATCCGCCTCTAGTATCAAGTCCTAGA
CTCAGTGTTGGTCCCCTGAGTCGACTTTGT|ATAGATTTCAAACTTAGTAATGTACTGCCG
TTGAGTCGACTTTGTAACGGATAGATTTCA|CTTTGTAACGGATAGATTTCAACATTGTGC
GATAGATTTCAAACGCGCTGAGTCGACTTT|ATCTCACATCCACATCGTCAAACGGCCCAG
TAGATTTCAAACTTAGTAATGTACTGCCGT|ACTTATTTGTTGAGTCGACTTTGTAACGGA
CTGAGTCGACTTTGTAACGGATAGATTTCA|CACCCGCAGGCATGTAACACCACTTATTTG
TCACTCGTTGAGTCGACTTTGTAACGGATA|GAGTCGACTTTGTAACGGATAGATTTCAAC
ACTTTGTAACGGATAGATTTCAAAGTCTGT|ATCGGCGTGTGAAAAGCATAACTGCCGCGA
CTCGCGCCTTCTCCATTATATGAGTCGACT|TAACGGATAGATTTCAATAACCAATTTAAA
ATCTCATGATCTACGTACAAATGGTCTCCG|ATAGATTTCAATCCGTCAATATTCTGTTGT
CCATCAAATTGTGAGTCGACTTTGTAACGG|AGTACTTATTATCGGCCTCCGCTGAGCTCG
GATAGATTTCAAGCCCTAGGGTTAATTTTT|TGGCCACGCAGGGGCTCTGAGTCGACTTTG
ATGTACTGCCGTTCCATCTCACATCCACAT|CTTTGTAACGGATAGATTTCAAGAGTCGAC
ATATGAGTCGACTTTGTAACGGATAGATTT|TTGAGTCGACTTTGTAACGGATAGATTTCA
TTTGTAACGGATAGATTTCAACCGATCTCA|TGTAACGGATAGATTTCAAAACGGATAGAT
GCCTTCTCCATTATATGAGTCGACTTTGTA|GATAGATTTCAATAACCAATTTAAAACGAC
GAGTCGACTTTGTAACGGATAGATTTCAAC|CGGCCTCCGCTGAGCTCGTACGCATAGATA
GAATGCGCAGTGGCCACGCAGGGGCTCTGA|TTTCAATACACCTCACTGTCGGCATACGAA
GAAAAGCATAACTGCCGCGAATGCAATTGG|GATAGATTTCAAGTATCAGCGATCACTTCT
GCCGACATCACACCCGCAGGCATGTAACAC|TGTACTTCAATAGGGACTTTCATACCAAAG
ACACCTCACTGTCGGCATACGAAGCCGTGA|TCGACTTTGTAACGGATAGATTTCAACGCG
AGCATATATCACCAGAATTCGCTCGCGCCT|AAACGCGCTGAGTCGACTTTGTAACGGATA
ATGATCTACGTACAAATGGTCTCCGAAGCA|TTTCAATCCGTCAATATTCTGTTGTTGAGT
ACCGATCTCATGATCTACGTACAAATGGTC|ACGGATAGATTTCAATCCGTCAATATTCTG
TTTTAGAGACCGGCTGCCGGACTTCAAAAG|GGTCCCCTGAGTCGACTTTGTAACGGATAG
ACAAATGGTCTCCGAAGCATCTGCCCTCCC|CAATATTCTGTTGTTGAGTCGACTTTGTAA
CGTCAAACGGCCCAGAGCGCATGCGCCATT|TTTGTAACGGATAGATTTCAAGTGGTTCGA
TGTTCTGATTTTTAGAGACCGGCTGCCGGA|CTCAGTGTTGGTCCCCTGAGTCGACTTTGT
TGTAACGGATAGATTTCAAGTATCAGCGAT|TATCCGCCTCTAGTATCAAGTCCTAGATAC
AACTGCAGTACTTATTATCGGCCTCCGCTG|TTTTATGAGCAACAAGACACAGTTCGGTGT
TTTCAACATTGTGCGCTGCTGAGTCGACTT|ATAGATATGTCTAAACGATTTAAATGCGTC
GACTTTGTAACGGATAGATTTCAAAGTCTG|TATCGGCGTGTGAAAAGCATAACTGCCGCG
TTGTTGAGTCGACTTTGTAACGGATAGATT|GTCTCCTGTAAAGGGCAACGAGGCGCTGCT
TCACATCCACATCGTCAAACGGCCCAGAGC|TCAAGAGTCGACTTTGTAACGGATAGATTT
GCTCGCGCCTTCTCCATTATATGAGTCGAC|GTAACGGATAGATTTCAATAACCAATTTAA
TTCATACCAAAGCGTACTTGTCTCCTGTAA|AATGAGTCGACTTTGTAACGGATAGATTTC
TACACCTTAACGCTCGTTCACTCGTTGAGT|AATAGCCATCAAATTGTGAGTCGACTTTGT
AAACTTCTCCTGGTACACTGAGGTCGGAGT|GTACAAATGGTCTCCGAAGCATCTGCCCTC
CGACTTTGTAACGGATAGATTTCAAGTATC|TGCGTCTATCCGCCTCTAGTATCAAGTCCT
TGTTGAGTCGACTTTGTAACGGATAGATTT|GCTAGTACACCTTAACGCTCGTTCACTCGT
TTTAAAACGACCACAAGACAGCTGAGTCGA|CCTAACCTGATGCCGACATCACACCCGCAG
TGGTCCCCTGAGTCGACTTTGTAACGGATA|CAAACTTAGTAATGTACTGCCGTTCCATCT
CGGATAGATTTCAACATTGTGCGCTGCTGA|TCGTACGCATAGATATGTCTAAACGATTTA
TTGAGTCGACTTTGTAACGGATAGATTTCA|AGTCGACTTTGTAACGGATAGATTTCAAAG
AACGCGCTGGTACTATCGGCGTGTGAAAAG|CGCTGCTGAGTCGACTTTGTAACGGATAGA
ATCAAATTGTGAGTCGACTTTGTAACGGAT|TACTTATTATCGGCCTCCGCTGAGCTCGTA
ACTTTGTAACGGATAGATTTCAACATTGTG|CCGCTGAGCTCGTACGCATAGATATGTCTA
AGTGGTTCGAGGGACGCGGGGTAATCTTGA|CACAATATTTGTCGCGTTTAAACTTCTCCT
TTTGTAACGGATAGATTTCAACTGTCGTAA|AACGACCACAAGACAGCTGAGTCGACTTTG
TATTCTGTTGTTGAGTCGACTTTGTAACGG|TGTATAAGGCTAGTACACCTTAACGCTCGT
CGCTGGTACTATCGGCGTGTGAAAAGCATA|GCTGAGTCGACTTTGTAACGGATAGATTTC
CGTGAGTGAGTCGACTTTGTAACGGATAGA|ACGCGCTGGTACTATCGGCGTGTGAAAAGC
GGTACTATCGGCGTGTGAAAAGCATAACTG|AGTCGACTTTGTAACGGATAGATTTCAAGT
AACTGTCGTAATCTCGACTCAGTGTTGGTC|AGTCGACTTTGTAACGGATAGATTTCAAAC
TGGCAACTGTATAAGGCTAGTACACCTTAA|GTATAACATTGACCCATGAGAATAGCCATC
AACCGATCTCATGATCTACGTACAAATGGT|AACGGATAGATTTCAATCCGTCAATATTCT
CGACTTTGTAACGGATAGATTTCAAGTGGT|GAGATAGATGCGCCTGAGCATTTACACAAT
CGACTTTGTTGAGTCGACTTTGTAACGGAT|CGTGAGTGAGTCGACTTTGTAACGGATAGA
ATAGATTTCAATACACCTCACTGTCGGCAT|TCACTCGTTGAGTCGACTTTGTAACGGATA
GAGAATAGCCATCAAATTGTGAGTCGACTT|ACAACTGCAGTACTTATTATCGGCCTCCGC
GTAACGGATAGATTTCAAGTGGTTCGAGGG|ATGCGCCTGAGCATTTACACAATATTTGTC
AACAGCATATATCACCAGAATTCGCTCGCG|TTCAAACGCGCTGAGTCGACTTTGTAACGG
GCAACGAGGCGCTGCTCACGTAAAGAGATA|CCCTAGGGTTAATTTTTATATGAGTCGACT
ATTCGCTCGCGCCTTCTCCATTATATGAGT|CTTTGTAACGGATAGATTTCAATAACCAAT
TAGGGTTAATTTTTATATGAGTCGACTTTG|CTGAGTCGACTTTGTTGAGTCGACTTTGTA
GTTTAAACTTCTCCTGGTACACTGAGGTCG|CTACGTACAAATGGTCTCCGAAGCATCTGC
ACGGATAGATTTCAAGAGTCGACTTTGTAA|GAGGCGCTGCTCACGTAAAGAGATAGATGC
ACACTGAGGTCGGAGTAATGAGTCGACTTT|CGAAGCATCTGCCCTCCCTCCAAGCCGAAT
CCTGATGCCGACATCACACCCGCAGGCATG|CTTGAATGTACTTCAATAGGGACTTTCATA
AACGGATAGATTTCAATAACCAATTTAAAA|CGCATGCGCCATTAACGTCGCTACCTAACC
GTATAACATTGACCCATGAGAATAGCCATC|CCAAACATTGCAGGTTTACAACTGCAGTAC
CACCTCACTGTCGGCATACGAAGCCGTGAG|CGACTTTGTAACGGATAGATTTCAACGCGC
ACTTTGTAACGGATAGATTTCAATAACCAA|CCCAGAGCGCATGCGCCATTAACGTCGCTA
GCAAACAGCATATATCACCAGAATTCGCTC|GATTTCAAACGCGCTGAGTCGACTTTGTAA
TTCAACATTGTGCGCTGCTGAGTCGACTTT|TAGATATGTCTAAACGATTTAAATGCGTCT
CATTAACGTCGCTACCTAACCTGATGCCGA|TCGAGGGACGCGGGGTAATCTTGAATGTAC
TATGAGTCGACTTTGTAACGGATAGATTTC|AACCAATTTAAAACGACCACAAGACAGCTG
AAGAGATAGATGCGCCTGAGCATTTACACA|AGTCGACTTTGTAACGGATAGATTTCAACC
CAACTGTCGTAATCTCGACTCAGTGTTGGT|GAGTCGACTTTGTAACGGATAGATTTCAAA
TGTAACGGATAGATTTCAACCGATCTCATG|TAACGGATAGATTTCAAAACGGATAGATTT
TGAGTGAGTCGACTTTGTAACGGATAGATT|GCGCTGGTACTATCGGCGTGTGAAAAGCAT
TAACGGATAGATTTCAAGCCCTAGGGTTAA|CGCAGTGGCCACGCAGGGGCTCTGAGTCGA
AAATGGTCTCCGAAGCATCTGCCCTCCCTC|ATATTCTGTTGTTGAGTCGACTTTGTAACG
AGATTTCAACGCGCTGGTACTATCGGCGTG|CATTGTGCGCTGCTGAGTCGACTTTGTAAC
TGCGCCTGAGCATTTACACAATATTTGTCG|GTAACGGATAGATTTCAACCGATCTCATGA
TTTGTAACGGATAGATTTCAACGCGCTGGT|GATAGATTTCAACATTGTGCGCTGCTGAGT
GAGCTCTACTGTGGCAACTGTATAAGGCTA|GCAATTGGGGTGTATAACATTGACCCATGA
TTGTAACGGATAGATTTCAATAACCAATTT|AGAGCGCATGCGCCATTAACGTCGCTACCT
TCTCCTGTAAAGGGCAACGAGGCGCTGCTC|GATAGATTTCAAGCCCTAGGGTTAATTTTT
TTTACAACTGCAGTACTTATTATCGGCCTC|AGCCATTTTATGAGCAACAAGACACAGTTC
TAGGGACTTTCATACCAAAGCGTACTTGTC|GTCGGAGTAATGAGTCGACTTTGTAACGGA
GATTTCAACCGATCTCATGATCTACGTACA|TTTCAAAACGGATAGATTTCAATCCGTCAA
ATTATATGAGTCGACTTTGTAACGGATAGA|CAATAACCAATTTAAAACGACCACAAGACA
AGCATCTGCCCTCCCTCCAAGCCGAATGCG|GAGTCGACTTTGTAACGGATAGATTTCAAT
AACGGATAGATTTCAATACACCTCACTGTC|CTCGTTCACTCGTTGAGTCGACTTTGTAAC
ACAGCATATATCACCAGAATTCGCTCGCGC|TCAAACGCGCTGAGTCGACTTTGTAACGGA
ATGCGCAGTGGCCACGCAGGGGCTCTGAGT|TCAATACACCTCACTGTCGGCATACGAAGC
ACTGTGGCAACTGTATAAGGCTAGTACACC|GGGTGTATAACATTGACCCATGAGAATAGC
AATATTCTGTTGTTGAGTCGACTTTGTAAC|ACTGTATAAGGCTAGTACACCTTAACGCTC
TTCAACCGATCTCATGATCTACGTACAAAT|CAAAACGGATAGATTTCAATCCGTCAATAT
ACCTGATGCCGACATCACACCCGCAGGCAT|TCTTGAATGTACTTCAATAGGGACTTTCAT
TAGATTTCAACTGTCGTAATCTCGACTCAG|GACAGCTGAGTCGACTTTGTAACGGATAGA
ATAGATTTCAAGTGGTTCGAGGGACGCGGG|TGAGCATTTACACAATATTTGTCGCGTTTA
CAATCCGTCAATATTCTGTTGTTGAGTCGA|ACTGTGGCAACTGTATAAGGCTAGTACACC
CTGGTACACTGAGGTCGGAGTAATGAGTCG|GTCTCCGAAGCATCTGCCCTCCCTCCAAGC
CTCCATTATATGAGTCGACTTTGTAACGGA|ATTTCAATAACCAATTTAAAACGACCACAA
GTAACGGATAGATTTCAATAACCAATTTAA|AGCGCATGCGCCATTAACGTCGCTACCTAA
TTGTAACGGATAGATTTCAACTGTCGTAAT|ACGACCACAAGACAGCTGAGTCGACTTTGT
ATTTGGAGTGTGTTCTGATTTTTAGAGACC|GTAATCTCGACTCAGTGTTGGTCCCCTGAG
TTTGTAACGGATAGATTTCAAGCCCTAGGG|AATGCGCAGTGGCCACGCAGGGGCTCTGAG
CTCACATCCACATCGTCAAACGGCCCAGAG|TTCAAGAGTCGACTTTGTAACGGATAGATT
ATTGACCCATGAGAATAGCCATCAAATTGT|TTGCAGGTTTACAACTGCAGTACTTATTAT
ACCACAAGACAGCTGAGTCGACTTTGTAAC|ATGCCGACATCACACCCGCAGGCATGTAAC
GCCATTAACGTCGCTACCTAACCTGATGCC|GTTCGAGGGACGCGGGGTAATCTTGAATGT
TCAGTGTTGGTCCCCTGAGTCGACTTTGTA|TAGATTTCAAACTTAGTAATGTACTGCCGT
GGATAGATTTCAAGCCCTAGGGTTAATTTT|GTGGCCACGCAGGGGCTCTGAGTCGACTTT
GAGTCGACTTTGTAACGGATAGATTTCAAC|GTCGACTTTGTAACGGATAGATTTCAAAAC
GGATAGATTTCAAACTTAGTAATGTACTGC|ACCACTTATTTGTTGAGTCGACTTTGTAAC
CCCGCAGGCATGTAACACCACTTATTTGTT|GGGACTTTCATACCAAAGCGTACTTGTCTC
TCAAACGGCCCAGAGCGCATGCGCCATTAA|TGTAACGGATAGATTTCAAGTGGTTCGAGG
CATGTAACACCACTTATTTGTTGAGTCGAC|CATACCAAAGCGTACTTGTCTCCTGTAAAG
TCGACTTTGTAACGGATAGATTTCAAGTGG|AGAGATAGATGCGCCTGAGCATTTACACAA
TGTGAGTCGACTTTGTAACGGATAGATTTC|TATCGGCCTCCGCTGAGCTCGTACGCATAG
TCGACTTTGTAACGGATAGATTTCAAGTAT|ATGCGTCTATCCGCCTCTAGTATCAAGTCC
CAAGCCCTAGGGTTAATTTTTATATGAGTC|AGGGGCTCTGAGTCGACTTTGTTGAGTCGA
TAACGGATAGATTTCAATAACCAATTTAAA|GCGCATGCGCCATTAACGTCGCTACCTAAC
TCACTGTCGGCATACGAAGCCGTGAGTGAG|TTTGTAACGGATAGATTTCAACGCGCTGGT
TGTACTTCAATAGGGACTTTCATACCAAAG|GTACACTGAGGTCGGAGTAATGAGTCGACT
CATTGTGCGCTGCTGAGTCGACTTTGTAAC|ATGTCTAAACGATTTAAATGCGTCTATCCG
ATCTACGTACAAATGGTCTCCGAAGCATCT|CAATCCGTCAATATTCTGTTGTTGAGTCGA
CCTTAACGCTCGTTCACTCGTTGAGTCGAC|GCCATCAAATTGTGAGTCGACTTTGTAACG
ACTTCTCCTGGTACACTGAGGTCGGAGTAA|ACAAATGGTCTCCGAAGCATCTGCCCTCCC
GACGCGGGGTAATCTTGAATGTACTTCAAT|CGCGTTTAAACTTCTCCTGGTACACTGAGG
TCAACTGTCGTAATCTCGACTCAGTGTTGG|TGAGTCGACTTTGTAACGGATAGATTTCAA
GTCGGAGTAATGAGTCGACTTTGTAACGGA|CTGCCCTCCCTCCAAGCCGAATGCGCAGTG
CCACTTATTTGTTGAGTCGACTTTGTAACG|GCGTACTTGTCTCCTGTAAAGGGCAACGAG
TATAAGGCTAGTACACCTTAACGCTCGTTC|TGACCCATGAGAATAGCCATCAAATTGTGA
AGTATCAGCGATCACTTCTATCCCAAACAT|AGTCCTAGATACTCGCTATTTGTGCGCCTT
AGATTTCAAGAGTCGACTTTGTAACGGATA|CTGCTCACGTAAAGAGATAGATGCGCCTGA
ACCCATGAGAATAGCCATCAAATTGTGAGT|AGGTTTACAACTGCAGTACTTATTATCGGC
TTGTAACGGATAGATTTCAAAACGGATAGA|TAACGGATAGATTTCAAAGTCTGTGAGAGC
GATTTCAACTGTCGTAATCTCGACTCAGTG|CAGCTGAGTCGACTTTGTAACGGATAGATT
CACGCAGGGGCTCTGAGTCGACTTTGTTGA|ACTGTCGGCATACGAAGCCGTGAGTGAGTC
GGACTTTCATACCAAAGCGTACTTGTCTCC|GGAGTAATGAGTCGACTTTGTAACGGATAG
CGCTCGTTCACTCGTTGAGTCGACTTTGTA|AAATTGTGAGTCGACTTTGTAACGGATAGA
TCATACCAAAGCGTACTTGTCTCCTGTAAA|ATGAGTCGACTTTGTAACGGATAGATTTCA
TCCCCTGAGTCGACTTTGTAACGGATAGAT|ACTTAGTAATGTACTGCCGTTCCATCTCAC
TAGATTTCAAGTATCAGCGATCACTTCTAT|CTAGTATCAAGTCCTAGATACTCGCTATTT
GGTTCGAGGGACGCGGGGTAATCTTGAATG|AATATTTGTCGCGTTTAAACTTCTCCTGGT
TAACGGATAGATTTCAACTGTCGTAATCTC|ACCACAAGACAGCTGAGTCGACTTTGTAAC
ATAACTGCCGCGAATGCAATTGGGGTGTAT|TTCAAGTATCAGCGATCACTTCTATCCCAA
CGGATAGATTTCAACCGATCTCATGATCTA|GATAGATTTCAAAACGGATAGATTTCAATC
TTGAGTCGACTTTGTAACGGATAGATTTCA|TCCTGTAAAGGGCAACGAGGCGCTGCTCAC
TGTGGCAACTGTATAAGGCTAGTACACCTT|GTGTATAACATTGACCCATGAGAATAGCCA
ATAGATTTCAACTGTCGTAATCTCGACTCA|AGACAGCTGAGTCGACTTTGTAACGGATAG
TAGATTTCAATCCGTCAATATTCTGTTGTT|GAGCTCTACTGTGGCAACTGTATAAGGCTA
AATTCGCTCGCGCCTTCTCCATTATATGAG|ACTTTGTAACGGATAGATTTCAATAACCAA
ATCCCAAACATTGCAGGTTTACAACTGCAG|TTGTGCGCCTTCGCCGAAGCCATTTTATGA
CGAATGCAATTGGGGTGTATAACATTGACC|AGCGATCACTTCTATCCCAAACATTGCAGG
TTGACCCATGAGAATAGCCATCAAATTGTG|TGCAGGTTTACAACTGCAGTACTTATTATC
AACTTCTCCTGGTACACTGAGGTCGGAGTA|TACAAATGGTCTCCGAAGCATCTGCCCTCC
GTACAAATGGTCTCCGAAGCATCTGCCCTC|GTCAATATTCTGTTGTTGAGTCGACTTTGT
TAACGTCGCTACCTAACCTGATGCCGACAT|AGGGACGCGGGGTAATCTTGAATGTACTTC
ACACCACTTATTTGTTGAGTCGACTTTGTA|AAAGCGTACTTGTCTCCTGTAAAGGGCAAC
CGGATAGATTTCAACGCGCTGGTACTATCG|TTCAACATTGTGCGCTGCTGAGTCGACTTT
TTCTGTTGTTGAGTCGACTTTGTAACGGAT|TATAAGGCTAGTACACCTTAACGCTCGTTC
GCATGTAACACCACTTATTTGTTGAGTCGA|TCATACCAAAGCGTACTTGTCTCCTGTAAA
TGTCGTAATCTCGACTCAGTGTTGGTCCCC|CGACTTTGTAACGGATAGATTTCAAACTTA
TATCGGCGTGTGAAAAGCATAACTGCCGCG|ACTTTGTAACGGATAGATTTCAAGTATCAG
CGGAGTAATGAGTCGACTTTGTAACGGATA|GCCCTCCCTCCAAGCCGAATGCGCAGTGGC
CCGCAGGCATGTAACACCACTTATTTGTTG|GGACTTTCATACCAAAGCGTACTTGTCTCC
CGGATAGATTTCAAGTATCAGCGATCACTT|GCCTCTAGTATCAAGTCCTAGATACTCGCT
TTATATGAGTCGACTTTGTAACGGATAGAT|AATAACCAATTTAAAACGACCACAAGACAG
AACGGATAGATTTCAAAGTCTGTGAGAGCT|TGTGAAAAGCATAACTGCCGCGAATGCAAT
ATAGCCATCAAATTGTGAGTCGACTTTGTA|CTGCAGTACTTATTATCGGCCTCCGCTGAG
GTAACGGATAGATTTCAAGAGTCGACTTTG|AACGAGGCGCTGCTCACGTAAAGAGATAGA
ATCACTTCTATCCCAAACATTGCAGGTTTA|ACTCGCTATTTGTGCGCCTTCGCCGAAGCC
TCAAAACGGATAGATTTCAATCCGTCAATA|AAGTCTGTGAGAGCTCTACTGTGGCAACTG
GCATCTGCCCTCCCTCCAAGCCGAATGCGC|AGTCGACTTTGTAACGGATAGATTTCAATA
ACGGATAGATTTCAACATTGTGCGCTGCTG|CTCGTACGCATAGATATGTCTAAACGATTT
ATGAGTCGACTTTGTAACGGATAGATTTCA|ACCAATTTAAAACGACCACAAGACAGCTGA
GGTTAATTTTTATATGAGTCGACTTTGTAA|AGTCGACTTTGTTGAGTCGACTTTGTAACG
GCCCAGAGCGCATGCGCCATTAACGTCGCT|GATAGATTTCAAGTGGTTCGAGGGACGCGG
ACTGTCGGCATACGAAGCCGTGAGTGAGTC|TGTAACGGATAGATTTCAACGCGCTGGTAC
ACTGCCGTTCCATCTCACATCCACATCGTC|GTAACGGATAGATTTCAAGAGTCGACTTTG
TGTAACGGATAGATTTCAAGCCCTAGGGTT|TGCGCAGTGGCCACGCAGGGGCTCTGAGTC
GACATCACACCCGCAGGCATGTAACACCAC|ACTTCAATAGGGACTTTCATACCAAAGCGT
CACCCGCAGGCATGTAACACCACTTATTTG|TAGGGACTTTCATACCAAAGCGTACTTGTC
TATTTGGAGTGTGTTCTGATTTTTAGAGAC|CGTAATCTCGACTCAGTGTTGGTCCCCTGA
GGATAGATTTCAATACACCTCACTGTCGGC|GTTCACTCGTTGAGTCGACTTTGTAACGGA
TTTTTAGAGACCGGCTGCCGGACTTCAAAA|TGGTCCCCTGAGTCGACTTTGTAACGGATA
GCATAACTGCCGCGAATGCAATTGGGGTGT|ATTTCAAGTATCAGCGATCACTTCTATCCC
ACTGAGGTCGGAGTAATGAGTCGACTTTGT|AAGCATCTGCCCTCCCTCCAAGCCGAATGC
ACTTTGTAACGGATAGATTTCAAGCCCTAG|CGAATGCGCAGTGGCCACGCAGGGGCTCTG
TTTACACAATATTTGTCGCGTTTAAACTTC|TTTCAACCGATCTCATGATCTACGTACAAA
TATCCCAAACATTGCAGGTTTACAACTGCA|TTTGTGCGCCTTCGCCGAAGCCATTTTATG
GTACTTGTCTCCTGTAAAGGGCAACGAGGC|TGTAACGGATAGATTTCAAGCCCTAGGGTT
TTACAACTGCAGTACTTATTATCGGCCTCC|GCCATTTTATGAGCAACAAGACACAGTTCG
TACAAATGGTCTCCGAAGCATCTGCCCTCC|TCAATATTCTGTTGTTGAGTCGACTTTGTA
AAACGCGCTGAGTCGACTTTGTAACGGATA|CACATCGTCAAACGGCCCAGAGCGCATGCG
TAAAACGACCACAAGACAGCTGAGTCGACT|TAACCTGATGCCGACATCACACCCGCAGGC
ACGCGGGGTAATCTTGAATGTACTTCAATA|GCGTTTAAACTTCTCCTGGTACACTGAGGT
CAATATTCTGTTGTTGAGTCGACTTTGTAA|AACTGTATAAGGCTAGTACACCTTAACGCT
ATAGGGACTTTCATACCAAAGCGTACTTGT|GGTCGGAGTAATGAGTCGACTTTGTAACGG
GTAATGTACTGCCGTTCCATCTCACATCCA|CGACTTTGTAACGGATAGATTTCAAGAGTC
GTCAATATTCTGTTGTTGAGTCGACTTTGT|GCAACTGTATAAGGCTAGTACACCTTAACG
CACATCGTCAAACGGCCCAGAGCGCATGCG|TCGACTTTGTAACGGATAGATTTCAAGTGG
TTTGTAACGGATAGATTTCAAAGTCTGTGA|CGGCGTGTGAAAAGCATAACTGCCGCGAAT
CATCCACATCGTCAAACGGCCCAGAGCGCA|AGAGTCGACTTTGTAACGGATAGATTTCAA
GAGTCGACTTTGTAACGGATAGATTTCAAA|CCCGCAGGCATGTAACACCACTTATTTGTT
TTCAAGTGGTTCGAGGGACGCGGGGTAATC|TTTACACAATATTTGTCGCGTTTAAACTTC
CGACTTTGTAACGGATAGATTTCAACATTG|CTCCGCTGAGCTCGTACGCATAGATATGTC
GTGTATAACATTGACCCATGAGAATAGCCA|TCCCAAACATTGCAGGTTTACAACTGCAGT
GATCTCATGATCTACGTACAAATGGTCTCC|GATAGATTTCAATCCGTCAATATTCTGTTG
AGGCATGTAACACCACTTATTTGTTGAGTC|TTTCATACCAAAGCGTACTTGTCTCCTGTA
ACGGATAGATTTCAACCGATCTCATGATCT|GGATAGATTTCAAAACGGATAGATTTCAAT
ACTTTGTAACGGATAGATTTCAATACACCT|CTTAACGCTCGTTCACTCGTTGAGTCGACT
CAAACTTAGTAATGTACTGCCGTTCCATCT|TGTTGAGTCGACTTTGTAACGGATAGATTT
AAGACAGCTGAGTCGACTTTGTAACGGATA|GACATCACACCCGCAGGCATGTAACACCAC
GTCGCGTTTAAACTTCTCCTGGTACACTGA|ATGATCTACGTACAAATGGTCTCCGAAGCA
AGCTCTACTGTGGCAACTGTATAAGGCTAG|CAATTGGGGTGTATAACATTGACCCATGAG
AACGGATAGATTTCAAGTATCAGCGATCAC|CCGCCTCTAGTATCAAGTCCTAGATACTCG
AATGAGTCGACTTTGTAACGGATAGATTTC|CCTCCAAGCCGAATGCGCAGTGGCCACGCA
ATGAGTCGACTTTGTAACGGATAGATTTCA|GAGTCGACTTTGTAACGGATAGATTTCAAA
GATTTCAACATTGTGCGCTGCTGAGTCGAC|GCATAGATATGTCTAAACGATTTAAATGCG
AACGGATAGATTTCAAAACGGATAGATTTC|GGATAGATTTCAAAGTCTGTGAGAGCTCTA
AATCTCGACTCAGTGTTGGTCCCCTGAGTC|TGTAACGGATAGATTTCAAACTTAGTAATG
TTCAATAACCAATTTAAAACGACCACAAGA|TTAACGTCGCTACCTAACCTGATGCCGACA
TAATGTACTGCCGTTCCATCTCACATCCAC|GACTTTGTAACGGATAGATTTCAAGAGTCG
AGTCGACTTTGTTGAGTCGACTTTGTAACG|AGCCGTGAGTGAGTCGACTTTGTAACGGAT
GATTTCAAACGCGCTGAGTCGACTTTGTAA|CACATCCACATCGTCAAACGGCCCAGAGCG
ATAGATTTCAAAGTCTGTGAGAGCTCTACT|AAAGCATAACTGCCGCGAATGCAATTGGGG
GCGATCACTTCTATCCCAAACATTGCAGGT|GATACTCGCTATTTGTGCGCCTTCGCCGAA
GGACTTCAAAAGCAAACAGCATATATCACC|TGTAACGGATAGATTTCAAACGCGCTGAGT
AATTTAAAACGACCACAAGACAGCTGAGTC|TACCTAACCTGATGCCGACATCACACCCGC
CTCGTTCACTCGTTGAGTCGACTTTGTAAC|ATTGTGAGTCGACTTTGTAACGGATAGATT
TACTATCGGCGTGTGAAAAGCATAACTGCC|TCGACTTTGTAACGGATAGATTTCAAGTAT
CGATCACTTCTATCCCAAACATTGCAGGTT|ATACTCGCTATTTGTGCGCCTTCGCCGAAG
GAGCGCATGCGCCATTAACGTCGCTACCTA|ATTTCAAGTGGTTCGAGGGACGCGGGGTAA
CGGATAGATTTCAAGAGTCGACTTTGTAAC|AGGCGCTGCTCACGTAAAGAGATAGATGCG
AAGTCTGTGAGAGCTCTACTGTGGCAACTG|TGCCGCGAATGCAATTGGGGTGTATAACAT
TTGTTGAGTCGACTTTGTAACGGATAGATT|GTGAGTCGACTTTGTAACGGATAGATTTCA
AAGCGTACTTGTCTCCTGTAAAGGGCAACG|ACTTTGTAACGGATAGATTTCAAGCCCTAG
ATGCCGACATCACACCCGCAGGCATGTAAC|AATGTACTTCAATAGGGACTTTCATACCAA
CACTTATTTGTTGAGTCGACTTTGTAACGG|CGTACTTGTCTCCTGTAAAGGGCAACGAGG
CCATTATATGAGTCGACTTTGTAACGGATA|TTCAATAACCAATTTAAAACGACCACAAGA
CCTTCTCCATTATATGAGTCGACTTTGTAA|ATAGATTTCAATAACCAATTTAAAACGACC
GCGCTGAGTCGACTTTGTAACGGATAGATT|TCGTCAAACGGCCCAGAGCGCATGCGCCAT
CCAGAATTCGCTCGCGCCTTCTCCATTATA|GTCGACTTTGTAACGGATAGATTTCAATAA
CCTGGTACACTGAGGTCGGAGTAATGAGTC|GGTCTCCGAAGCATCTGCCCTCCCTCCAAG
TAACGGATAGATTTCAACCGATCTCATGAT|ACGGATAGATTTCAAAACGGATAGATTTCA
GTCGACTTTGTAACGGATAGATTTCAAGTG|AAGAGATAGATGCGCCTGAGCATTTACACA
CCAAAGCGTACTTGTCTCCTGTAAAGGGCA|TCGACTTTGTAACGGATAGATTTCAAGCCC
TCCATCTCACATCCACATCGTCAAACGGCC|TAGATTTCAAGAGTCGACTTTGTAACGGAT
GATAGATTTCAACGCGCTGGTACTATCGGC|CAACATTGTGCGCTGCTGAGTCGACTTTGT
TAGATTTCAAGAGTCGACTTTGTAACGGAT|GCTGCTCACGTAAAGAGATAGATGCGCCTG
AGGTTTACAACTGCAGTACTTATTATCGGC|CGAAGCCATTTTATGAGCAACAAGACACAG
ACTGTCGTAATCTCGACTCAGTGTTGGTCC|GTCGACTTTGTAACGGATAGATTTCAAACT
GTTCACTCGTTGAGTCGACTTTGTAACGGA|GTGAGTCGACTTTGTAACGGATAGATTTCA
TGCAGGTTTACAACTGCAGTACTTATTATC|CGCCGAAGCCATTTTATGAGCAACAAGACA
TGGGGTGTATAACATTGACCCATGAGAATA|TCTATCCCAAACATTGCAGGTTTACAACTG
TCGTAATCTCGACTCAGTGTTGGTCCCCTG|ACTTTGTAACGGATAGATTTCAAACTTAGT
ACAACTGCAGTACTTATTATCGGCCTCCGC|CATTTTATGAGCAACAAGACACAGTTCGGT
TCGTCAAACGGCCCAGAGCGCATGCGCCAT|CTTTGTAACGGATAGATTTCAAGTGGTTCG
TAGATTTCAATACACCTCACTGTCGGCATA|CACTCGTTGAGTCGACTTTGTAACGGATAG
ACGGATAGATTTCAATAACCAATTTAAAAC|GCATGCGCCATTAACGTCGCTACCTAACCT
CCTCACTGTCGGCATACGAAGCCGTGAGTG|ACTTTGTAACGGATAGATTTCAACGCGCTG
GTCGACTTTGTAACGGATAGATTTCAAACG|ATGTACTGCCGTTCCATCTCACATCCACAT
TGTTGAGTCGACTTTGTAACGGATAGATTT|TCTCCTGTAAAGGGCAACGAGGCGCTGCTC
TGTAACACCACTTATTTGTTGAGTCGACTT|TACCAAAGCGTACTTGTCTCCTGTAAAGGG
AGTCGACTTTGTAACGGATAGATTTCAACT|AATTTAAAACGACCACAAGACAGCTGAGTC
CTACCTAACCTGATGCCGACATCACACCCG|GGGGTAATCTTGAATGTACTTCAATAGGGA
GGGACGCGGGGTAATCTTGAATGTACTTCA|GTCGCGTTTAAACTTCTCCTGGTACACTGA
TTCAAGAGTCGACTTTGTAACGGATAGATT|TCACGTAAAGAGATAGATGCGCCTGAGCAT
AGATTTCAAGTATCAGCGATCACTTCTATC|TAGTATCAAGTCCTAGATACTCGCTATTTG
GTCGACTTTGTAACGGATAGATTTCAAGCC|AAGCCGAATGCGCAGTGGCCACGCAGGGGC
CGAAGCATCTGCCCTCCCTCCAAGCCGAAT|GTTGAGTCGACTTTGTAACGGATAGATTTC
CCCTCCCTCCAAGCCGAATGCGCAGTGGCC|TTTGTAACGGATAGATTTCAATACACCTCA
CGCGCTGAGTCGACTTTGTAACGGATAGAT|ATCGTCAAACGGCCCAGAGCGCATGCGCCA
CGCGTTTAAACTTCTCCTGGTACACTGAGG|GATCTACGTACAAATGGTCTCCGAAGCATC
ATTTGTTGAGTCGACTTTGTAACGGATAGA|TTGTCTCCTGTAAAGGGCAACGAGGCGCTG
GTAACGGATAGATTTCAAAGTCTGTGAGAG|CGTGTGAAAAGCATAACTGCCGCGAATGCA
GTACTATCGGCGTGTGAAAAGCATAACTGC|GTCGACTTTGTAACGGATAGATTTCAAGTA
ACGGATAGATTTCAATCCGTCAATATTCTG|TGTGAGAGCTCTACTGTGGCAACTGTATAA
AAACGGATAGATTTCAATCCGTCAATATTC|TCTGTGAGAGCTCTACTGTGGCAACTGTAT
ACGCAGGGGCTCTGAGTCGACTTTGTTGAG|CTGTCGGCATACGAAGCCGTGAGTGAGTCG
GATTTCAAACTTAGTAATGTACTGCCGTTC|TTATTTGTTGAGTCGACTTTGTAACGGATA
TAACTGCCGCGAATGCAATTGGGGTGTATA|TCAAGTATCAGCGATCACTTCTATCCCAAA
TAGATTTCAAAGTCTGTGAGAGCTCTACTG|AAGCATAACTGCCGCGAATGCAATTGGGGT
TCCACATCGTCAAACGGCCCAGAGCGCATG|AGTCGACTTTGTAACGGATAGATTTCAAGT
TGTAACGGATAGATTTCAAACGCGCTGAGT|CCGTTCCATCTCACATCCACATCGTCAAAC
TGGTACACTGAGGTCGGAGTAATGAGTCGA|TCTCCGAAGCATCTGCCCTCCCTCCAAGCC
CTGCTGAGTCGACTTTGTAACGGATAGATT|CGATTTAAATGCGTCTATCCGCCTCTAGTA
ACGAAGCCGTGAGTGAGTCGACTTTGTAAC|GATTTCAACGCGCTGGTACTATCGGCGTGT
GTAACACCACTTATTTGTTGAGTCGACTTT|ACCAAAGCGTACTTGTCTCCTGTAAAGGGC
CTTCTCCTGGTACACTGAGGTCGGAGTAAT|CAAATGGTCTCCGAAGCATCTGCCCTCCCT
TCAAACTTAGTAATGTACTGCCGTTCCATC|TTGTTGAGTCGACTTTGTAACGGATAGATT
TACTGCCGTTCCATCTCACATCCACATCGT|TGTAACGGATAGATTTCAAGAGTCGACTTT
TGTAACGGATAGATTTCAATACACCTCACT|ACGCTCGTTCACTCGTTGAGTCGACTTTGT
AACATTGTGCGCTGCTGAGTCGACTTTGTA|ATATGTCTAAACGATTTAAATGCGTCTATC
TCAAGCCCTAGGGTTAATTTTTATATGAGT|CAGGGGCTCTGAGTCGACTTTGTTGAGTCG
ACATCACACCCGCAGGCATGTAACACCACT|CTTCAATAGGGACTTTCATACCAAAGCGTA
GTAACGGATAGATTTCAAGTATCAGCGATC|ATCCGCCTCTAGTATCAAGTCCTAGATACT
TAACGGATAGATTTCAAGTGGTTCGAGGGA|TGCGCCTGAGCATTTACACAATATTTGTCG
GTCGACTTTGTAACGGATAGATTTCAAACT|CGCAGGCATGTAACACCACTTATTTGTTGA
AAGCATCTGCCCTCCCTCCAAGCCGAATGC|TGAGTCGACTTTGTAACGGATAGATTTCAA
CGACCACAAGACAGCTGAGTCGACTTTGTA|TGATGCCGACATCACACCCGCAGGCATGTA
ACGGATAGATTTCAATACACCTCACTGTCG|TCGTTCACTCGTTGAGTCGACTTTGTAACG
TCTCGACTCAGTGTTGGTCCCCTGAGTCGA|TAACGGATAGATTTCAAACTTAGTAATGTA
GGTGTATAACATTGACCCATGAGAATAGCC|ATCCCAAACATTGCAGGTTTACAACTGCAG
GATAGATGCGCCTGAGCATTTACACAATAT|GACTTTGTAACGGATAGATTTCAACCGATC
CGGATAGATTTCAAAGTCTGTGAGAGCTCT|TGAAAAGCATAACTGCCGCGAATGCAATTG
GCAGGTTTACAACTGCAGTACTTATTATCG|GCCGAAGCCATTTTATGAGCAACAAGACAC
GTTGAGTCGACTTTGTAACGGATAGATTTC|GAGTCGACTTTGTAACGGATAGATTTCAAA
GGATAGATTTCAACATTGTGCGCTGCTGAG|CGTACGCATAGATATGTCTAAACGATTTAA
CAGGGGCTCTGAGTCGACTTTGTTGAGTCG|TCGGCATACGAAGCCGTGAGTGAGTCGACT
CGGATAGATTTCAATAACCAATTTAAAACG|CATGCGCCATTAACGTCGCTACCTAACCTG
GCTCTGAGTCGACTTTGTTGAGTCGACTTT|ATACGAAGCCGTGAGTGAGTCGACTTTGTA
GGCAACTGTATAAGGCTAGTACACCTTAAC|TATAACATTGACCCATGAGAATAGCCATCA
CTTTGTAACGGATAGATTTCAAACGCGCTG|CTGCCGTTCCATCTCACATCCACATCGTCA
GACTTTGTAACGGATAGATTTCAACGCGCT|ACGGATAGATTTCAACATTGTGCGCTGCTG
TACACTGAGGTCGGAGTAATGAGTCGACTT|CCGAAGCATCTGCCCTCCCTCCAAGCCGAA
CGCTACCTAACCTGATGCCGACATCACACC|GCGGGGTAATCTTGAATGTACTTCAATAGG
CCGAATGCGCAGTGGCCACGCAGGGGCTCT|GATTTCAATACACCTCACTGTCGGCATACG
AGTCGACTTTGTAACGGATAGATTTCAAGT|AAAGAGATAGATGCGCCTGAGCATTTACAC
ATTTCAAACGCGCTGAGTCGACTTTGTAAC|ACATCCACATCGTCAAACGGCCCAGAGCGC
GCCGAATGCGCAGTGGCCACGCAGGGGCTC|AGATTTCAATACACCTCACTGTCGGCATAC
GGCCCAGAGCGCATGCGCCATTAACGTCGC|GGATAGATTTCAAGTGGTTCGAGGGACGCG
GACTTTGTAACGGATAGATTTCAATAACCA|GCCCAGAGCGCATGCGCCATTAACGTCGCT
CGACTTTGTAACGGATAGATTTCAATAACC|GGCCCAGAGCGCATGCGCCATTAACGTCGC
TTCGCTCGCGCCTTCTCCATTATATGAGTC|TTTGTAACGGATAGATTTCAATAACCAATT
GCTGAGTCGACTTTGTAACGGATAGATTTC|ACACCCGCAGGCATGTAACACCACTTATTT
GCAGGCATGTAACACCACTTATTTGTTGAG|ACTTTCATACCAAAGCGTACTTGTCTCCTG
GAGTCGACTTTGTAACGGATAGATTTCAAC|TTGTAACGGATAGATTTCAACATTGTGCGC
TCGCTACCTAACCTGATGCCGACATCACAC|CGCGGGGTAATCTTGAATGTACTTCAATAG
TCAAAAGCAAACAGCATATATCACCAGAAT|CGGATAGATTTCAAACGCGCTGAGTCGACT
ACTGCAGTACTTATTATCGGCCTCCGCTGA|TTTATGAGCAACAAGACACAGTTCGGTGTC
ACATCCACATCGTCAAACGGCCCAGAGCGC|AAGAGTCGACTTTGTAACGGATAGATTTCA
TTCTCCTGGTACACTGAGGTCGGAGTAATG|AAATGGTCTCCGAAGCATCTGCCCTCCCTC
TAGTACACCTTAACGCTCGTTCACTCGTTG|GAGAATAGCCATCAAATTGTGAGTCGACTT
GCTCTACTGTGGCAACTGTATAAGGCTAGT|AATTGGGGTGTATAACATTGACCCATGAGA
CGACTTTGTAACGGATAGATTTCAACGCGC|AACGGATAGATTTCAACATTGTGCGCTGCT
CTTTGTAACGGATAGATTTCAATAACCAAT|CCAGAGCGCATGCGCCATTAACGTCGCTAC
CGACTTTGTAACGGATAGATTTCAACCGAT|ACTTTGTAACGGATAGATTTCAAAACGGAT
GATTTTTAGAGACCGGCTGCCGGACTTCAA|GTTGGTCCCCTGAGTCGACTTTGTAACGGA
TCACTTCTATCCCAAACATTGCAGGTTTAC|CTCGCTATTTGTGCGCCTTCGCCGAAGCCA
AACGGATAGATTTCAACCGATCTCATGATC|CGGATAGATTTCAAAACGGATAGATTTCAA
GTGTTCTGATTTTTAGAGACCGGCTGCCGG|ACTCAGTGTTGGTCCCCTGAGTCGACTTTG
GCGCTGCTCACGTAAAGAGATAGATGCGCC|TTAATTTTTATATGAGTCGACTTTGTAACG
ATATTTGTCGCGTTTAAACTTCTCCTGGTA|GATCTCATGATCTACGTACAAATGGTCTCC
AGATTTCAATACACCTCACTGTCGGCATAC|ACTCGTTGAGTCGACTTTGTAACGGATAGA
TAACGCTCGTTCACTCGTTGAGTCGACTTT|ATCAAATTGTGAGTCGACTTTGTAACGGAT
ATATATCACCAGAATTCGCTCGCGCCTTCT|CGCGCTGAGTCGACTTTGTAACGGATAGAT
ATACGAAGCCGTGAGTGAGTCGACTTTGTA|TAGATTTCAACGCGCTGGTACTATCGGCGT
GTGTGTTCTGATTTTTAGAGACCGGCTGCC|CGACTCAGTGTTGGTCCCCTGAGTCGACTT
TTTCAACGCGCTGGTACTATCGGCGTGTGA|TGTGCGCTGCTGAGTCGACTTTGTAACGGA
TGTAACGGATAGATTTCAACATTGTGCGCT|TGAGCTCGTACGCATAGATATGTCTAAACG
GGCATGTAACACCACTTATTTGTTGAGTCG|TTCATACCAAAGCGTACTTGTCTCCTGTAA
TGTACTGCCGTTCCATCTCACATCCACATC|TTTGTAACGGATAGATTTCAAGAGTCGACT
TTTCAATAACCAATTTAAAACGACCACAAG|ATTAACGTCGCTACCTAACCTGATGCCGAC
AGATTTCAACTGTCGTAATCTCGACTCAGT|ACAGCTGAGTCGACTTTGTAACGGATAGAT
AGATTTCAATAACCAATTTAAAACGACCAC|GCCATTAACGTCGCTACCTAACCTGATGCC
TCTGTGAGAGCTCTACTGTGGCAACTGTAT|CGCGAATGCAATTGGGGTGTATAACATTGA
CGGATAGATTTCAAACGCGCTGAGTCGACT|CCATCTCACATCCACATCGTCAAACGGCCC
ACGTAAAGAGATAGATGCGCCTGAGCATTT|ATATGAGTCGACTTTGTAACGGATAGATTT
AAACATTGCAGGTTTACAACTGCAGTACTT|CGCCTTCGCCGAAGCCATTTTATGAGCAAC
TCAACATTGTGCGCTGCTGAGTCGACTTTG|AGATATGTCTAAACGATTTAAATGCGTCTA
TCAAGTGGTTCGAGGGACGCGGGGTAATCT|TTACACAATATTTGTCGCGTTTAAACTTCT
GGGGTGTATAACATTGACCCATGAGAATAG|CTATCCCAAACATTGCAGGTTTACAACTGC
AGCATTTACACAATATTTGTCGCGTTTAAA|TAGATTTCAACCGATCTCATGATCTACGTA
TAATGAGTCGACTTTGTAACGGATAGATTT|CCCTCCAAGCCGAATGCGCAGTGGCCACGC
ACTGTATAAGGCTAGTACACCTTAACGCTC|ACATTGACCCATGAGAATAGCCATCAAATT
GTCGTAATCTCGACTCAGTGTTGGTCCCCT|GACTTTGTAACGGATAGATTTCAAACTTAG
TTCAACTGTCGTAATCTCGACTCAGTGTTG|CTGAGTCGACTTTGTAACGGATAGATTTCA
GAGGCGCTGCTCACGTAAAGAGATAGATGC|GGGTTAATTTTTATATGAGTCGACTTTGTA
GTAATCTCGACTCAGTGTTGGTCCCCTGAG|TTTGTAACGGATAGATTTCAAACTTAGTAA
AACGGATAGATTTCAACATTGTGCGCTGCT|GCTCGTACGCATAGATATGTCTAAACGATT
AGATTTCAAGCCCTAGGGTTAATTTTTATA|CCACGCAGGGGCTCTGAGTCGACTTTGTTG
GAGTCGACTTTGTAACGGATAGATTTCAAC|CAATTTAAAACGACCACAAGACAGCTGAGT
TGGTTCGAGGGACGCGGGGTAATCTTGAAT|CAATATTTGTCGCGTTTAAACTTCTCCTGG
TACCTAACCTGATGCCGACATCACACCCGC|GGGTAATCTTGAATGTACTTCAATAGGGAC
ATTTCAACTGTCGTAATCTCGACTCAGTGT|AGCTGAGTCGACTTTGTAACGGATAGATTT
CACGTAAAGAGATAGATGCGCCTGAGCATT|TATATGAGTCGACTTTGTAACGGATAGATT
CAAAAGCAAACAGCATATATCACCAGAATT|GGATAGATTTCAAACGCGCTGAGTCGACTT
TTCAACGCGCTGGTACTATCGGCGTGTGAA|GTGCGCTGCTGAGTCGACTTTGTAACGGAT
ATCACCAGAATTCGCTCGCGCCTTCTCCAT|CTGAGTCGACTTTGTAACGGATAGATTTCA
ACATCGTCAAACGGCCCAGAGCGCATGCGC|CGACTTTGTAACGGATAGATTTCAAGTGGT
AGTCGACTTTGTAACGGATAGATTTCAAGC|CAAGCCGAATGCGCAGTGGCCACGCAGGGG
TCTCATGATCTACGTACAAATGGTCTCCGA|TAGATTTCAATCCGTCAATATTCTGTTGTT
AGAGACCGGCTGCCGGACTTCAAAAGCAAA|CCCTGAGTCGACTTTGTAACGGATAGATTT
GTTAATTTTTATATGAGTCGACTTTGTAAC|GTCGACTTTGTTGAGTCGACTTTGTAACGG
TCGACTTTGTAACGGATAGATTTCAACTGT|TTTAAAACGACCACAAGACAGCTGAGTCGA
GCTCGTTCACTCGTTGAGTCGACTTTGTAA|AATTGTGAGTCGACTTTGTAACGGATAGAT
GTCCCCTGAGTCGACTTTGTAACGGATAGA|AACTTAGTAATGTACTGCCGTTCCATCTCA
GGCATACGAAGCCGTGAGTGAGTCGACTTT|GGATAGATTTCAACGCGCTGGTACTATCGG
GATAGATTTCAATACACCTCACTGTCGGCA|TTCACTCGTTGAGTCGACTTTGTAACGGAT
TATCACCAGAATTCGCTCGCGCCTTCTCCA|GCTGAGTCGACTTTGTAACGGATAGATTTC
GAGTGAGTCGACTTTGTAACGGATAGATTT|CGCTGGTACTATCGGCGTGTGAAAAGCATA
GTCGACTTTGTAACGGATAGATTTCAACCG|CGACTTTGTAACGGATAGATTTCAAAACGG
TAACATTGACCCATGAGAATAGCCATCAAA|AACATTGCAGGTTTACAACTGCAGTACTTA
TACTTGTCTCCTGTAAAGGGCAACGAGGCG|GTAACGGATAGATTTCAAGCCCTAGGGTTA
GCTGCTCACGTAAAGAGATAGATGCGCCTG|AATTTTTATATGAGTCGACTTTGTAACGGA
GTAACGGATAGATTTCAACCGATCTCATGA|AACGGATAGATTTCAAAACGGATAGATTTC
TTTATATGAGTCGACTTTGTAACGGATAGA|TTGTTGAGTCGACTTTGTAACGGATAGATT
TGTGAGAGCTCTACTGTGGCAACTGTATAA|CGAATGCAATTGGGGTGTATAACATTGACC
TCAAACGCGCTGAGTCGACTTTGTAACGGA|TCCACATCGTCAAACGGCCCAGAGCGCATG
GTCTGTGAGAGCTCTACTGTGGCAACTGTA|CCGCGAATGCAATTGGGGTGTATAACATTG
CAAAGCGTACTTGTCTCCTGTAAAGGGCAA|CGACTTTGTAACGGATAGATTTCAAGCCCT
AGAGATAGATGCGCCTGAGCATTTACACAA|GTCGACTTTGTAACGGATAGATTTCAACCG
TAATCTCGACTCAGTGTTGGTCCCCTGAGT|TTGTAACGGATAGATTTCAAACTTAGTAAT
ACGGATAGATTTCAACTGTCGTAATCTCGA|CACAAGACAGCTGAGTCGACTTTGTAACGG
AGATTTCAACATTGTGCGCTGCTGAGTCGA|CGCATAGATATGTCTAAACGATTTAAATGC
ATAGATTTCAAGAGTCGACTTTGTAACGGA|CGCTGCTCACGTAAAGAGATAGATGCGCCT
TCGACTTTGTAACGGATAGATTTCAAACTT|GCAGGCATGTAACACCACTTATTTGTTGAG
CGGACTTCAAAAGCAAACAGCATATATCAC|TTGTAACGGATAGATTTCAAACGCGCTGAG
AAAAGCATAACTGCCGCGAATGCAATTGGG|ATAGATTTCAAGTATCAGCGATCACTTCTA
AAAGCGTACTTGTCTCCTGTAAAGGGCAAC|GACTTTGTAACGGATAGATTTCAAGCCCTA
GTTTACAACTGCAGTACTTATTATCGGCCT|AAGCCATTTTATGAGCAACAAGACACAGTT
GCGCATGCGCCATTAACGTCGCTACCTAAC|TTCAAGTGGTTCGAGGGACGCGGGGTAATC
TAAACTTCTCCTGGTACACTGAGGTCGGAG|CGTACAAATGGTCTCCGAAGCATCTGCCCT
GTCGACTTTGTAACGGATAGATTTCAACAT|GCCTCCGCTGAGCTCGTACGCATAGATATG
ACTTTGTAACGGATAGATTTCAACCGATCT|TTTGTAACGGATAGATTTCAAAACGGATAG
TGAGTCGACTTTGTAACGGATAGATTTCAA|TCGGCCTCCGCTGAGCTCGTACGCATAGAT
GATTTCAAGTATCAGCGATCACTTCTATCC|AGTATCAAGTCCTAGATACTCGCTATTTGT
CGGCGTGTGAAAAGCATAACTGCCGCGAAT|TTGTAACGGATAGATTTCAAGTATCAGCGA
TACACAATATTTGTCGCGTTTAAACTTCTC|TCAACCGATCTCATGATCTACGTACAAATG
ATTTCAATAACCAATTTAAAACGACCACAA|CATTAACGTCGCTACCTAACCTGATGCCGA
GTTCCATCTCACATCCACATCGTCAAACGG|GATAGATTTCAAGAGTCGACTTTGTAACGG
TGGCCACGCAGGGGCTCTGAGTCGACTTTG|CCTCACTGTCGGCATACGAAGCCGTGAGTG
TACGTACAAATGGTCTCCGAAGCATCTGCC|TCCGTCAATATTCTGTTGTTGAGTCGACTT
GCTAGTACACCTTAACGCTCGTTCACTCGT|ATGAGAATAGCCATCAAATTGTGAGTCGAC
TTAAACTTCTCCTGGTACACTGAGGTCGGA|ACGTACAAATGGTCTCCGAAGCATCTGCCC
AGTACACCTTAACGCTCGTTCACTCGTTGA|AGAATAGCCATCAAATTGTGAGTCGACTTT
TTAATTTTTATATGAGTCGACTTTGTAACG|TCGACTTTGTTGAGTCGACTTTGTAACGGA
CGTGTGAAAAGCATAACTGCCGCGAATGCA|TAACGGATAGATTTCAAGTATCAGCGATCA
ACGAGGCGCTGCTCACGTAAAGAGATAGAT|TAGGGTTAATTTTTATATGAGTCGACTTTG
CGTTCACTCGTTGAGTCGACTTTGTAACGG|TGTGAGTCGACTTTGTAACGGATAGATTTC
ACTATCGGCGTGTGAAAAGCATAACTGCCG|CGACTTTGTAACGGATAGATTTCAAGTATC
CCTGAGCATTTACACAATATTTGTCGCGTT|CGGATAGATTTCAACCGATCTCATGATCTA
GAGTCGACTTTGTAACGGATAGATTTCAAG|TAAAGAGATAGATGCGCCTGAGCATTTACA
GGATAGATTTCAAGAGTCGACTTTGTAACG|GGCGCTGCTCACGTAAAGAGATAGATGCGC
ATAGATTTCAATAACCAATTTAAAACGACC|GCGCCATTAACGTCGCTACCTAACCTGATG
CATACCAAAGCGTACTTGTCTCCTGTAAAG|TGAGTCGACTTTGTAACGGATAGATTTCAA
AGGCTAGTACACCTTAACGCTCGTTCACTC|CCATGAGAATAGCCATCAAATTGTGAGTCG
TCGTTGAGTCGACTTTGTAACGGATAGATT|CGACTTTGTAACGGATAGATTTCAACATTG
TTGTAACGGATAGATTTCAAACTTAGTAAT|ATGTAACACCACTTATTTGTTGAGTCGACT
ACTTTGTAACGGATAGATTTCAAACGCGCT|ACTGCCGTTCCATCTCACATCCACATCGTC
TAACGGATAGATTTCAAAACGGATAGATTT|CGGATAGATTTCAAAGTCTGTGAGAGCTCT
TCTACGTACAAATGGTCTCCGAAGCATCTG|AATCCGTCAATATTCTGTTGTTGAGTCGAC
ATTTCAACGCGCTGGTACTATCGGCGTGTG|TTGTGCGCTGCTGAGTCGACTTTGTAACGG
CGACTTTGTAACGGATAGATTTCAAGAGTC|AAAGGGCAACGAGGCGCTGCTCACGTAAAG
GAGGTCGGAGTAATGAGTCGACTTTGTAAC|CATCTGCCCTCCCTCCAAGCCGAATGCGCA
AGTCGACTTTGTAACGGATAGATTTCAACC|TCGACTTTGTAACGGATAGATTTCAAAACG
CCATGAGAATAGCCATCAAATTGTGAGTCG|GTTTACAACTGCAGTACTTATTATCGGCCT
TTTGGAGTGTGTTCTGATTTTTAGAGACCG|TAATCTCGACTCAGTGTTGGTCCCCTGAGT
TTTGTAACGGATAGATTTCAAGTGGTTCGA|TAGATGCGCCTGAGCATTTACACAATATTT
TAAGGCTAGTACACCTTAACGCTCGTTCAC|ACCCATGAGAATAGCCATCAAATTGTGAGT
TAATTTTTATATGAGTCGACTTTGTAACGG|CGACTTTGTTGAGTCGACTTTGTAACGGAT
GAATGCAATTGGGGTGTATAACATTGACCC|GCGATCACTTCTATCCCAAACATTGCAGGT
CCCTAGGGTTAATTTTTATATGAGTCGACT|GCTCTGAGTCGACTTTGTTGAGTCGACTTT
AGATTTCAAAGTCTGTGAGAGCTCTACTGT|AGCATAACTGCCGCGAATGCAATTGGGGTG
TTTCAACTGTCGTAATCTCGACTCAGTGTT|GCTGAGTCGACTTTGTAACGGATAGATTTC
TCTATCCCAAACATTGCAGGTTTACAACTG|TATTTGTGCGCCTTCGCCGAAGCCATTTTA
TAACGGATAGATTTCAAACGCGCTGAGTCG|GTTCCATCTCACATCCACATCGTCAAACGG
AATCCGTCAATATTCTGTTGTTGAGTCGAC|CTGTGGCAACTGTATAAGGCTAGTACACCT
ACGCGCTGAGTCGACTTTGTAACGGATAGA|CATCGTCAAACGGCCCAGAGCGCATGCGCC
AGACAGCTGAGTCGACTTTGTAACGGATAG|ACATCACACCCGCAGGCATGTAACACCACT
CTTCAATAGGGACTTTCATACCAAAGCGTA|ACTGAGGTCGGAGTAATGAGTCGACTTTGT
ATCTCACATCCACATCGTCAAACGGCCCAG|ATTTCAAGAGTCGACTTTGTAACGGATAGA
CTTCTCCATTATATGAGTCGACTTTGTAAC|TAGATTTCAATAACCAATTTAAAACGACCA
TTCAAACTTAGTAATGTACTGCCGTTCCAT|TTTGTTGAGTCGACTTTGTAACGGATAGAT
TTGTCGCGTTTAAACTTCTCCTGGTACACT|TCATGATCTACGTACAAATGGTCTCCGAAG
TTAGTAATGTACTGCCGTTCCATCTCACAT|AGTCGACTTTGTAACGGATAGATTTCAAGA
TTCAAGTATCAGCGATCACTTCTATCCCAA|ATCAAGTCCTAGATACTCGCTATTTGTGCG
CCAATTTAAAACGACCACAAGACAGCTGAG|GCTACCTAACCTGATGCCGACATCACACCC
AGTCGACTTTGTAACGGATAGATTTCAACA|GGCCTCCGCTGAGCTCGTACGCATAGATAT
TTTCAAACGCGCTGAGTCGACTTTGTAACG|CATCCACATCGTCAAACGGCCCAGAGCGCA
GATAGATTTCAAAACGGATAGATTTCAATC|AGATTTCAAAGTCTGTGAGAGCTCTACTGT
TTTGTCGCGTTTAAACTTCTCCTGGTACAC|CTCATGATCTACGTACAAATGGTCTCCGAA
TCGACTTTGTTGAGTCGACTTTGTAACGGA|CCGTGAGTGAGTCGACTTTGTAACGGATAG
TTGGGGTGTATAACATTGACCCATGAGAAT|TTCTATCCCAAACATTGCAGGTTTACAACT
GAGTAATGAGTCGACTTTGTAACGGATAGA|CCTCCCTCCAAGCCGAATGCGCAGTGGCCA
GTCGACTTTGTAACGGATAGATTTCAACGC|GTAACGGATAGATTTCAACATTGTGCGCTG
ATGAGAATAGCCATCAAATTGTGAGTCGAC|TTACAACTGCAGTACTTATTATCGGCCTCC
GATTTCAACGCGCTGGTACTATCGGCGTGT|ATTGTGCGCTGCTGAGTCGACTTTGTAACG
GGCTCTGAGTCGACTTTGTTGAGTCGACTT|CATACGAAGCCGTGAGTGAGTCGACTTTGT
GAGTCGACTTTGTAACGGATAGATTTCAAG|CCAAGCCGAATGCGCAGTGGCCACGCAGGG
CGGATAGATTTCAAGCCCTAGGGTTAATTT|AGTGGCCACGCAGGGGCTCTGAGTCGACTT
TTGTAACGGATAGATTTCAAGAGTCGACTT|GCAACGAGGCGCTGCTCACGTAAAGAGATA
TAGATTTCAACGCGCTGGTACTATCGGCGT|ACATTGTGCGCTGCTGAGTCGACTTTGTAA
ATACCAAAGCGTACTTGTCTCCTGTAAAGG|GAGTCGACTTTGTAACGGATAGATTTCAAG
GACTTTGTAACGGATAGATTTCAAAACGGA|TTTGTAACGGATAGATTTCAAAGTCTGTGA
TTTCAAGTATCAGCGATCACTTCTATCCCA|TATCAAGTCCTAGATACTCGCTATTTGTGC
AACCAATTTAAAACGACCACAAGACAGCTG|TCGCTACCTAACCTGATGCCGACATCACAC
CAAACGGCCCAGAGCGCATGCGCCATTAAC|GTAACGGATAGATTTCAAGTGGTTCGAGGG
AAAGAGATAGATGCGCCTGAGCATTTACAC|GAGTCGACTTTGTAACGGATAGATTTCAAC
GGTTTACAACTGCAGTACTTATTATCGGCC|GAAGCCATTTTATGAGCAACAAGACACAGT
CATTGCAGGTTTACAACTGCAGTACTTATT|CTTCGCCGAAGCCATTTTATGAGCAACAAG
CTTTGTAACGGATAGATTTCAAGTGGTTCG|ATAGATGCGCCTGAGCATTTACACAATATT
TGTAACGGATAGATTTCAATAACCAATTTA|GAGCGCATGCGCCATTAACGTCGCTACCTA
AGATTTCAACCGATCTCATGATCTACGTAC|ATTTCAAAACGGATAGATTTCAATCCGTCA
GTGTGAAAAGCATAACTGCCGCGAATGCAA|AACGGATAGATTTCAAGTATCAGCGATCAC
CTCACGTAAAGAGATAGATGCGCCTGAGCA|TTTATATGAGTCGACTTTGTAACGGATAGA
TACTGTGGCAACTGTATAAGGCTAGTACAC|GGGGTGTATAACATTGACCCATGAGAATAG
TGCGCTGCTGAGTCGACTTTGTAACGGATA|TAAACGATTTAAATGCGTCTATCCGCCTCT
CTCCTGTAAAGGGCAACGAGGCGCTGCTCA|ATAGATTTCAAGCCCTAGGGTTAATTTTTA
CCATCTCACATCCACATCGTCAAACGGCCC|AGATTTCAAGAGTCGACTTTGTAACGGATA
CCCAGAGCGCATGCGCCATTAACGTCGCTA|ATAGATTTCAAGTGGTTCGAGGGACGCGGG
CAGCGATCACTTCTATCCCAAACATTGCAG|TAGATACTCGCTATTTGTGCGCCTTCGCCG
TAGCCATCAAATTGTGAGTCGACTTTGTAA|TGCAGTACTTATTATCGGCCTCCGCTGAGC
ACTCAGTGTTGGTCCCCTGAGTCGACTTTG|GATAGATTTCAAACTTAGTAATGTACTGCC
ACTTCAATAGGGACTTTCATACCAAAGCGT|CACTGAGGTCGGAGTAATGAGTCGACTTTG
AACACCACTTATTTGTTGAGTCGACTTTGT|CAAAGCGTACTTGTCTCCTGTAAAGGGCAA
CAACTGCAGTACTTATTATCGGCCTCCGCT|ATTTTATGAGCAACAAGACACAGTTCGGTG
GCGCCATTAACGTCGCTACCTAACCTGATG|TGGTTCGAGGGACGCGGGGTAATCTTGAAT
ATCAGCGATCACTTCTATCCCAAACATTGC|CCTAGATACTCGCTATTTGTGCGCCTTCGC
GCTGGTACTATCGGCGTGTGAAAAGCATAA|CTGAGTCGACTTTGTAACGGATAGATTTCA
TGCGCAGTGGCCACGCAGGGGCTCTGAGTC|CAATACACCTCACTGTCGGCATACGAAGCC
TGTAACGGATAGATTTCAAGTGGTTCGAGG|GATGCGCCTGAGCATTTACACAATATTTGT
GTAACGGATAGATTTCAAACGCGCTGAGTC|CGTTCCATCTCACATCCACATCGTCAAACG
AAACAGCATATATCACCAGAATTCGCTCGC|TTTCAAACGCGCTGAGTCGACTTTGTAACG
TTCAAAGTCTGTGAGAGCTCTACTGTGGCA|TAACTGCCGCGAATGCAATTGGGGTGTATA
AAAACGACCACAAGACAGCTGAGTCGACTT|AACCTGATGCCGACATCACACCCGCAGGCA
TAACGGATAGATTTCAAAGTCTGTGAGAGC|GTGTGAAAAGCATAACTGCCGCGAATGCAA
CTGTCGTAATCTCGACTCAGTGTTGGTCCC|TCGACTTTGTAACGGATAGATTTCAAACTT
GATCACTTCTATCCCAAACATTGCAGGTTT|TACTCGCTATTTGTGCGCCTTCGCCGAAGC
ATTTCAAGAGTCGACTTTGTAACGGATAGA|GCTCACGTAAAGAGATAGATGCGCCTGAGC
ACTTCAAAAGCAAACAGCATATATCACCAG|TAACGGATAGATTTCAAACGCGCTGAGTCG
ATAGATTTCAACCGATCTCATGATCTACGT|AGATTTCAAAACGGATAGATTTCAATCCGT
AGTAATGAGTCGACTTTGTAACGGATAGAT|CTCCCTCCAAGCCGAATGCGCAGTGGCCAC
TTTAGAGACCGGCTGCCGGACTTCAAAAGC|GTCCCCTGAGTCGACTTTGTAACGGATAGA
GATAGATTTCAAGTGGTTCGAGGGACGCGG|CTGAGCATTTACACAATATTTGTCGCGTTT
CAGTGGCCACGCAGGGGCTCTGAGTCGACT|ACACCTCACTGTCGGCATACGAAGCCGTGA
CATCACACCCGCAGGCATGTAACACCACTT|TTCAATAGGGACTTTCATACCAAAGCGTAC
ATAGATTTCAAACTTAGTAATGTACTGCCG|CACTTATTTGTTGAGTCGACTTTGTAACGG
TTCAATAGGGACTTTCATACCAAAGCGTAC|CTGAGGTCGGAGTAATGAGTCGACTTTGTA
GACTTTGTTGAGTCGACTTTGTAACGGATA|GTGAGTGAGTCGACTTTGTAACGGATAGAT
TTGGTCCCCTGAGTCGACTTTGTAACGGAT|TCAAACTTAGTAATGTACTGCCGTTCCATC
CTATCCCAAACATTGCAGGTTTACAACTGC|ATTTGTGCGCCTTCGCCGAAGCCATTTTAT
CTTTGTAACGGATAGATTTCAAGCCCTAGG|GAATGCGCAGTGGCCACGCAGGGGCTCTGA
CATGATCTACGTACAAATGGTCTCCGAAGC|ATTTCAATCCGTCAATATTCTGTTGTTGAG
CCAAACATTGCAGGTTTACAACTGCAGTAC|TGCGCCTTCGCCGAAGCCATTTTATGAGCA
GTTGGTCCCCTGAGTCGACTTTGTAACGGA|TTCAAACTTAGTAATGTACTGCCGTTCCAT
TCAACGCGCTGGTACTATCGGCGTGTGAAA|TGCGCTGCTGAGTCGACTTTGTAACGGATA
GAGTGTGTTCTGATTTTTAGAGACCGGCTG|CTCGACTCAGTGTTGGTCCCCTGAGTCGAC
CACAATATTTGTCGCGTTTAAACTTCTCCT|AACCGATCTCATGATCTACGTACAAATGGT
TAGATTTCAAGCCCTAGGGTTAATTTTTAT|GCCACGCAGGGGCTCTGAGTCGACTTTGTT
TGCTGAGTCGACTTTGTAACGGATAGATTT|GATTTAAATGCGTCTATCCGCCTCTAGTAT
GGGGCTCTGAGTCGACTTTGTTGAGTCGAC|GGCATACGAAGCCGTGAGTGAGTCGACTTT
TAACGGATAGATTTCAAGTATCAGCGATCA|TCCGCCTCTAGTATCAAGTCCTAGATACTC
CTATCGGCGTGTGAAAAGCATAACTGCCGC|GACTTTGTAACGGATAGATTTCAAGTATCA
TTCTCCATTATATGAGTCGACTTTGTAACG|AGATTTCAATAACCAATTTAAAACGACCAC
CGCGGGGTAATCTTGAATGTACTTCAATAG|CGTTTAAACTTCTCCTGGTACACTGAGGTC
TGCGCCATTAACGTCGCTACCTAACCTGAT|GTGGTTCGAGGGACGCGGGGTAATCTTGAA
CCGGCTGCCGGACTTCAAAAGCAAACAGCA|AGTCGACTTTGTAACGGATAGATTTCAAAC
ACCAGAATTCGCTCGCGCCTTCTCCATTAT|AGTCGACTTTGTAACGGATAGATTTCAATA
CTGATGCCGACATCACACCCGCAGGCATGT|TTGAATGTACTTCAATAGGGACTTTCATAC
AATAGGGACTTTCATACCAAAGCGTACTTG|AGGTCGGAGTAATGAGTCGACTTTGTAACG
CTTTGTAACGGATAGATTTCAAGAGTCGAC|GGGCAACGAGGCGCTGCTCACGTAAAGAGA
TTATTTGTTGAGTCGACTTTGTAACGGATA|ACTTGTCTCCTGTAAAGGGCAACGAGGCGC
ACGGATAGATTTCAAACGCGCTGAGTCGAC|TCCATCTCACATCCACATCGTCAAACGGCC
CGGGGTAATCTTGAATGTACTTCAATAGGG|TTTAAACTTCTCCTGGTACACTGAGGTCGG
TCTCCGAAGCATCTGCCCTCCCTCCAAGCC|TGTTGTTGAGTCGACTTTGTAACGGATAGA
TCGGAGTAATGAGTCGACTTTGTAACGGAT|TGCCCTCCCTCCAAGCCGAATGCGCAGTGG
TTTGTAACGGATAGATTTCAAACGCGCTGA|TGCCGTTCCATCTCACATCCACATCGTCAA
GTAACGGATAGATTTCAACATTGTGCGCTG|GAGCTCGTACGCATAGATATGTCTAAACGA
TGTAACGGATAGATTTCAACTGTCGTAATC|CGACCACAAGACAGCTGAGTCGACTTTGTA
TTCAAGCCCTAGGGTTAATTTTTATATGAG|GCAGGGGCTCTGAGTCGACTTTGTTGAGTC
TGTAACGGATAGATTTCAAGAGTCGACTTT|CAACGAGGCGCTGCTCACGTAAAGAGATAG
GTAACGGATAGATTTCAACTGTCGTAATCT|GACCACAAGACAGCTGAGTCGACTTTGTAA
GCATACGAAGCCGTGAGTGAGTCGACTTTG|GATAGATTTCAACGCGCTGGTACTATCGGC
GAATAGCCATCAAATTGTGAGTCGACTTTG|AACTGCAGTACTTATTATCGGCCTCCGCTG
TCTGAGTCGACTTTGTTGAGTCGACTTTGT|ACGAAGCCGTGAGTGAGTCGACTTTGTAAC
ATCGTCAAACGGCCCAGAGCGCATGCGCCA|ACTTTGTAACGGATAGATTTCAAGTGGTTC
ACTTTGTAACGGATAGATTTCAAACTTAGT|GGCATGTAACACCACTTATTTGTTGAGTCG
GACTCAGTGTTGGTCCCCTGAGTCGACTTT|GGATAGATTTCAAACTTAGTAATGTACTGC
CGCCTTCTCCATTATATGAGTCGACTTTGT|GGATAGATTTCAATAACCAATTTAAAACGA
CAACTGTATAAGGCTAGTACACCTTAACGC|TAACATTGACCCATGAGAATAGCCATCAAA
AACGGATAGATTTCAACGCGCTGGTACTAT|ATTTCAACATTGTGCGCTGCTGAGTCGACT
AACGGATAGATTTCAACTGTCGTAATCTCG|CCACAAGACAGCTGAGTCGACTTTGTAACG
TAGTAATGTACTGCCGTTCCATCTCACATC|GTCGACTTTGTAACGGATAGATTTCAAGAG
TGTGTTCTGATTTTTAGAGACCGGCTGCCG|GACTCAGTGTTGGTCCCCTGAGTCGACTTT
GGATAGATTTCAACCGATCTCATGATCTAC|ATAGATTTCAAAACGGATAGATTTCAATCC
TGCCGACATCACACCCGCAGGCATGTAACA|ATGTACTTCAATAGGGACTTTCATACCAAA
CTCCCTCCAAGCCGAATGCGCAGTGGCCAC|TGTAACGGATAGATTTCAATACACCTCACT
TCACGTAAAGAGATAGATGCGCCTGAGCAT|TTATATGAGTCGACTTTGTAACGGATAGAT
AGCCGAATGCGCAGTGGCCACGCAGGGGCT|TAGATTTCAATACACCTCACTGTCGGCATA
AAAGTCTGTGAGAGCTCTACTGTGGCAACT|CTGCCGCGAATGCAATTGGGGTGTATAACA
TCGACTCAGTGTTGGTCCCCTGAGTCGACT|ACGGATAGATTTCAAACTTAGTAATGTACT
GGTCCCCTGAGTCGACTTTGTAACGGATAG|AAACTTAGTAATGTACTGCCGTTCCATCTC
GATTTCAATACACCTCACTGTCGGCATACG|CTCGTTGAGTCGACTTTGTAACGGATAGAT
AATGCAATTGGGGTGTATAACATTGACCCA|CGATCACTTCTATCCCAAACATTGCAGGTT
CCGCGAATGCAATTGGGGTGTATAACATTG|ATCAGCGATCACTTCTATCCCAAACATTGC
GTGAGTCGACTTTGTAACGGATAGATTTCA|CTGGTACTATCGGCGTGTGAAAAGCATAAC
CTGCCGCGAATGCAATTGGGGTGTATAACA|AGTATCAGCGATCACTTCTATCCCAAACAT
TTTGTAACGGATAGATTTCAATAACCAATT|CAGAGCGCATGCGCCATTAACGTCGCTACC
AGTGTGTTCTGATTTTTAGAGACCGGCTGC|TCGACTCAGTGTTGGTCCCCTGAGTCGACT
AAATTGTGAGTCGACTTTGTAACGGATAGA|TTATTATCGGCCTCCGCTGAGCTCGTACGC
TGATGCCGACATCACACCCGCAGGCATGTA|TGAATGTACTTCAATAGGGACTTTCATACC
TGTCGCGTTTAAACTTCTCCTGGTACACTG|CATGATCTACGTACAAATGGTCTCCGAAGC
GATTTCAAGCCCTAGGGTTAATTTTTATAT|CACGCAGGGGCTCTGAGTCGACTTTGTTGA
CGACTTTGTAACGGATAGATTTCAAGCCCT|GCCGAATGCGCAGTGGCCACGCAGGGGCTC
CAAACAGCATATATCACCAGAATTCGCTCG|ATTTCAAACGCGCTGAGTCGACTTTGTAAC
ACCCGCAGGCATGTAACACCACTTATTTGT|AGGGACTTTCATACCAAAGCGTACTTGTCT
TGATCTACGTACAAATGGTCTCCGAAGCAT|TTCAATCCGTCAATATTCTGTTGTTGAGTC
ATATCACCAGAATTCGCTCGCGCCTTCTCC|CGCTGAGTCGACTTTGTAACGGATAGATTT
TGTAACGGATAGATTTCAAAGTCTGTGAGA|GCGTGTGAAAAGCATAACTGCCGCGAATGC
GAAGCATCTGCCCTCCCTCCAAGCCGAATG|TTGAGTCGACTTTGTAACGGATAGATTTCA
TCTACTGTGGCAACTGTATAAGGCTAGTAC|TTGGGGTGTATAACATTGACCCATGAGAAT
CGGCATACGAAGCCGTGAGTGAGTCGACTT|CGGATAGATTTCAACGCGCTGGTACTATCG
ATCTTGAATGTACTTCAATAGGGACTTTCA|TTCTCCTGGTACACTGAGGTCGGAGTAATG
TGCCCTCCCTCCAAGCCGAATGCGCAGTGG|ACTTTGTAACGGATAGATTTCAATACACCT
ATGCGCCATTAACGTCGCTACCTAACCTGA|AGTGGTTCGAGGGACGCGGGGTAATCTTGA
AGATTTCAATCCGTCAATATTCTGTTGTTG|AGCTCTACTGTGGCAACTGTATAAGGCTAG
AGTCGACTTTGTAACGGATAGATTTCAAGT|AAATGCGTCTATCCGCCTCTAGTATCAAGT
TACAACTGCAGTACTTATTATCGGCCTCCG|CCATTTTATGAGCAACAAGACACAGTTCGG
CATAACTGCCGCGAATGCAATTGGGGTGTA|TTTCAAGTATCAGCGATCACTTCTATCCCA
CGCTGCTCACGTAAAGAGATAGATGCGCCT|TAATTTTTATATGAGTCGACTTTGTAACGG
GGATAGATTTCAAACGCGCTGAGTCGACTT|CATCTCACATCCACATCGTCAAACGGCCCA
ATTTCAATCCGTCAATATTCTGTTGTTGAG|CTCTACTGTGGCAACTGTATAAGGCTAGTA
CCACGCAGGGGCTCTGAGTCGACTTTGTTG|CACTGTCGGCATACGAAGCCGTGAGTGAGT
AGACCGGCTGCCGGACTTCAAAAGCAAACA|CTGAGTCGACTTTGTAACGGATAGATTTCA
TCGACTTTGTAACGGATAGATTTCAATACA|CACCTTAACGCTCGTTCACTCGTTGAGTCG
AGCGATCACTTCTATCCCAAACATTGCAGG|AGATACTCGCTATTTGTGCGCCTTCGCCGA
GGCGTGTGAAAAGCATAACTGCCGCGAATG|TGTAACGGATAGATTTCAAGTATCAGCGAT
TAACCTGATGCCGACATCACACCCGCAGGC|AATCTTGAATGTACTTCAATAGGGACTTTC
CAAACGCGCTGAGTCGACTTTGTAACGGAT|CCACATCGTCAAACGGCCCAGAGCGCATGC
AGGCGCTGCTCACGTAAAGAGATAGATGCG|GGTTAATTTTTATATGAGTCGACTTTGTAA
GGGACTTTCATACCAAAGCGTACTTGTCTC|CGGAGTAATGAGTCGACTTTGTAACGGATA
GCGGGGTAATCTTGAATGTACTTCAATAGG|GTTTAAACTTCTCCTGGTACACTGAGGTCG
GACTTTGTAACGGATAGATTTCAAACGCGC|TACTGCCGTTCCATCTCACATCCACATCGT
CGACTTTGTAACGGATAGATTTCAAAACGG|CTTTGTAACGGATAGATTTCAAAGTCTGTG
CTTCAAAAGCAAACAGCATATATCACCAGA|AACGGATAGATTTCAAACGCGCTGAGTCGA
TTGTAACGGATAGATTTCAACGCGCTGGTA|ATAGATTTCAACATTGTGCGCTGCTGAGTC
ATAACCAATTTAAAACGACCACAAGACAGC|CGTCGCTACCTAACCTGATGCCGACATCAC
AGTCGACTTTGTAACGGATAGATTTCAATA|TACACCTTAACGCTCGTTCACTCGTTGAGT
TGAGCATTTACACAATATTTGTCGCGTTTA|GATAGATTTCAACCGATCTCATGATCTACG
AGTCGACTTTGTAACGGATAGATTTCAAAA|CGACTTTGTAACGGATAGATTTCAAAGTCT
CCTAACCTGATGCCGACATCACACCCGCAG|GTAATCTTGAATGTACTTCAATAGGGACTT
CGTACTTGTCTCCTGTAAAGGGCAACGAGG|TTGTAACGGATAGATTTCAAGCCCTAGGGT
TTGTTGAGTCGACTTTGTAACGGATAGATT|GGCTAGTACACCTTAACGCTCGTTCACTCG
GCCGTGAGTGAGTCGACTTTGTAACGGATA|CAACGCGCTGGTACTATCGGCGTGTGAAAA
CTGTCGGCATACGAAGCCGTGAGTGAGTCG|GTAACGGATAGATTTCAACGCGCTGGTACT
GCCACGCAGGGGCTCTGAGTCGACTTTGTT|TCACTGTCGGCATACGAAGCCGTGAGTGAG
TCGGCATACGAAGCCGTGAGTGAGTCGACT|ACGGATAGATTTCAACGCGCTGGTACTATC
CCCCTGAGTCGACTTTGTAACGGATAGATT|CTTAGTAATGTACTGCCGTTCCATCTCACA
CTTAACGCTCGTTCACTCGTTGAGTCGACT|CCATCAAATTGTGAGTCGACTTTGTAACGG
GGATAGATTTCAAAGTCTGTGAGAGCTCTA|GAAAAGCATAACTGCCGCGAATGCAATTGG
GACTTTGTAACGGATAGATTTCAACTGTCG|TAAAACGACCACAAGACAGCTGAGTCGACT
CGACTCAGTGTTGGTCCCCTGAGTCGACTT|CGGATAGATTTCAAACTTAGTAATGTACTG
TACGAAGCCGTGAGTGAGTCGACTTTGTAA|AGATTTCAACGCGCTGGTACTATCGGCGTG
ACTGCCGCGAATGCAATTGGGGTGTATAAC|AAGTATCAGCGATCACTTCTATCCCAAACA
TTCAATCCGTCAATATTCTGTTGTTGAGTC|CTACTGTGGCAACTGTATAAGGCTAGTACA
GCTGAGTCGACTTTGTAACGGATAGATTTC|GTCAAACGGCCCAGAGCGCATGCGCCATTA
ATTTCAAGCCCTAGGGTTAATTTTTATATG|ACGCAGGGGCTCTGAGTCGACTTTGTTGAG
CGTTCCATCTCACATCCACATCGTCAAACG|GGATAGATTTCAAGAGTCGACTTTGTAACG
TTGTAACGGATAGATTTCAATACACCTCAC|AACGCTCGTTCACTCGTTGAGTCGACTTTG
CTAGTACACCTTAACGCTCGTTCACTCGTT|TGAGAATAGCCATCAAATTGTGAGTCGACT
GTCGACTTTGTAACGGATAGATTTCAATAC|ACACCTTAACGCTCGTTCACTCGTTGAGTC
CCGAAGCATCTGCCCTCCCTCCAAGCCGAA|TGTTGAGTCGACTTTGTAACGGATAGATTT
TGAGTCGACTTTGTAACGGATAGATTTCAA|TGGTACTATCGGCGTGTGAAAAGCATAACT
ATAGATGCGCCTGAGCATTTACACAATATT|ACTTTGTAACGGATAGATTTCAACCGATCT
ACTTTCATACCAAAGCGTACTTGTCTCCTG|AGTAATGAGTCGACTTTGTAACGGATAGAT
GTCGACTTTGTTGAGTCGACTTTGTAACGG|GCCGTGAGTGAGTCGACTTTGTAACGGATA
AACGGATAGATTTCAAGTGGTTCGAGGGAC|GCGCCTGAGCATTTACACAATATTTGTCGC
TTGTAACGGATAGATTTCAAACGCGCTGAG|GCCGTTCCATCTCACATCCACATCGTCAAA
CATTGACCCATGAGAATAGCCATCAAATTG|ATTGCAGGTTTACAACTGCAGTACTTATTA
TTCAAACGCGCTGAGTCGACTTTGTAACGG|ATCCACATCGTCAAACGGCCCAGAGCGCAT
GTAAAGGGCAACGAGGCGCTGCTCACGTAA|TTTCAAGCCCTAGGGTTAATTTTTATATGA
AAAGCAAACAGCATATATCACCAGAATTCG|ATAGATTTCAAACGCGCTGAGTCGACTTTG
TGTTGTTGAGTCGACTTTGTAACGGATAGA|AAGGCTAGTACACCTTAACGCTCGTTCACT
AACGAGGCGCTGCTCACGTAAAGAGATAGA|CTAGGGTTAATTTTTATATGAGTCGACTTT
CCCATGAGAATAGCCATCAAATTGTGAGTC|GGTTTACAACTGCAGTACTTATTATCGGCC
AGCTGAGTCGACTTTGTAACGGATAGATTT|CACACCCGCAGGCATGTAACACCACTTATT
TTAAAACGACCACAAGACAGCTGAGTCGAC|CTAACCTGATGCCGACATCACACCCGCAGG
AACTGTATAAGGCTAGTACACCTTAACGCT|AACATTGACCCATGAGAATAGCCATCAAAT
CATCAAATTGTGAGTCGACTTTGTAACGGA|GTACTTATTATCGGCCTCCGCTGAGCTCGT
TTGTGCGCTGCTGAGTCGACTTTGTAACGG|GTCTAAACGATTTAAATGCGTCTATCCGCC
GCGCTGGTACTATCGGCGTGTGAAAAGCAT|TGCTGAGTCGACTTTGTAACGGATAGATTT
GCGCCTTCTCCATTATATGAGTCGACTTTG|CGGATAGATTTCAATAACCAATTTAAAACG
AGTCGACTTTGTAACGGATAGATTTCAAGA|TGTAAAGGGCAACGAGGCGCTGCTCACGTA
GAATGTACTTCAATAGGGACTTTCATACCA|CTGGTACACTGAGGTCGGAGTAATGAGTCG
GTATCAGCGATCACTTCTATCCCAAACATT|GTCCTAGATACTCGCTATTTGTGCGCCTTC
ACCGGCTGCCGGACTTCAAAAGCAAACAGC|GAGTCGACTTTGTAACGGATAGATTTCAAA
TTTGTAACGGATAGATTTCAAGAGTCGACT|GGCAACGAGGCGCTGCTCACGTAAAGAGAT
ATTTACACAATATTTGTCGCGTTTAAACTT|ATTTCAACCGATCTCATGATCTACGTACAA
ATAGATTTCAAGCCCTAGGGTTAATTTTTA|GGCCACGCAGGGGCTCTGAGTCGACTTTGT
TTGAGTCGACTTTGTAACGGATAGATTTCA|TAGTACACCTTAACGCTCGTTCACTCGTTG
TCAATAGGGACTTTCATACCAAAGCGTACT|TGAGGTCGGAGTAATGAGTCGACTTTGTAA
CGACTTTGTAACGGATAGATTTCAAACTTA|CAGGCATGTAACACCACTTATTTGTTGAGT
CCGGACTTCAAAAGCAAACAGCATATATCA|TTTGTAACGGATAGATTTCAAACGCGCTGA
AGCCATCAAATTGTGAGTCGACTTTGTAAC|GCAGTACTTATTATCGGCCTCCGCTGAGCT
TCGCTCGCGCCTTCTCCATTATATGAGTCG|TTGTAACGGATAGATTTCAATAACCAATTT
AACATTGACCCATGAGAATAGCCATCAAAT|ACATTGCAGGTTTACAACTGCAGTACTTAT
GTAACGGATAGATTTCAAACTTAGTAATGT|GTAACACCACTTATTTGTTGAGTCGACTTT
TTGTAACGGATAGATTTCAAAGTCTGTGAG|GGCGTGTGAAAAGCATAACTGCCGCGAATG
AATTGGGGTGTATAACATTGACCCATGAGA|ACTTCTATCCCAAACATTGCAGGTTTACAA
ATGCAATTGGGGTGTATAACATTGACCCAT|GATCACTTCTATCCCAAACATTGCAGGTTT
CTTTGTAACGGATAGATTTCAACGCGCTGG|GGATAGATTTCAACATTGTGCGCTGCTGAG
TATATGAGTCGACTTTGTAACGGATAGATT|ATAACCAATTTAAAACGACCACAAGACAGC
GGGCTCTGAGTCGACTTTGTTGAGTCGACT|GCATACGAAGCCGTGAGTGAGTCGACTTTG
AGTAATGTACTGCCGTTCCATCTCACATCC|TCGACTTTGTAACGGATAGATTTCAAGAGT
ATTGGGGTGTATAACATTGACCCATGAGAA|CTTCTATCCCAAACATTGCAGGTTTACAAC
TGTTGAGTCGACTTTGTAACGGATAGATTT|TGAGTCGACTTTGTAACGGATAGATTTCAA
ACTTCTATCCCAAACATTGCAGGTTTACAA|CGCTATTTGTGCGCCTTCGCCGAAGCCATT
ACCACTTATTTGTTGAGTCGACTTTGTAAC|AGCGTACTTGTCTCCTGTAAAGGGCAACGA
GTCGACTTTGTAACGGATAGATTTCAATAA|ACGGCCCAGAGCGCATGCGCCATTAACGTC
GATAGATTTCAAACTTAGTAATGTACTGCC|CCACTTATTTGTTGAGTCGACTTTGTAACG
TGGTCTCCGAAGCATCTGCCCTCCCTCCAA|TTCTGTTGTTGAGTCGACTTTGTAACGGAT
CCACATCGTCAAACGGCCCAGAGCGCATGC|GTCGACTTTGTAACGGATAGATTTCAAGTG
TAACACCACTTATTTGTTGAGTCGACTTTG|CCAAAGCGTACTTGTCTCCTGTAAAGGGCA
TCGCGTTTAAACTTCTCCTGGTACACTGAG|TGATCTACGTACAAATGGTCTCCGAAGCAT
GTCGACTTTGTAACGGATAGATTTCAAAAC|GACTTTGTAACGGATAGATTTCAAAGTCTG
ACTTTGTAACGGATAGATTTCAAAACGGAT|TTGTAACGGATAGATTTCAAAGTCTGTGAG
GTGGTTCGAGGGACGCGGGGTAATCTTGAA|ACAATATTTGTCGCGTTTAAACTTCTCCTG
GGGTTAATTTTTATATGAGTCGACTTTGTA|GAGTCGACTTTGTTGAGTCGACTTTGTAAC
TCAACCGATCTCATGATCTACGTACAAATG|AAAACGGATAGATTTCAATCCGTCAATATT
AGTCGACTTTGTAACGGATAGATTTCAAAC|CCGCAGGCATGTAACACCACTTATTTGTTG
TATTTGTTGAGTCGACTTTGTAACGGATAG|CTTGTCTCCTGTAAAGGGCAACGAGGCGCT
AAAGGGCAACGAGGCGCTGCTCACGTAAAG|TCAAGCCCTAGGGTTAATTTTTATATGAGT
GCGAATGCAATTGGGGTGTATAACATTGAC|CAGCGATCACTTCTATCCCAAACATTGCAG
AAACGGCCCAGAGCGCATGCGCCATTAACG|TAACGGATAGATTTCAAGTGGTTCGAGGGA
TTACACAATATTTGTCGCGTTTAAACTTCT|TTCAACCGATCTCATGATCTACGTACAAAT
CTCTACTGTGGCAACTGTATAAGGCTAGTA|ATTGGGGTGTATAACATTGACCCATGAGAA
TGTAACGGATAGATTTCAACGCGCTGGTAC|TAGATTTCAACATTGTGCGCTGCTGAGTCG
ATTAACGTCGCTACCTAACCTGATGCCGAC|CGAGGGACGCGGGGTAATCTTGAATGTACT
CACCAGAATTCGCTCGCGCCTTCTCCATTA|GAGTCGACTTTGTAACGGATAGATTTCAAT
TTGGAGTGTGTTCTGATTTTTAGAGACCGG|AATCTCGACTCAGTGTTGGTCCCCTGAGTC
CATGCGCCATTAACGTCGCTACCTAACCTG|AAGTGGTTCGAGGGACGCGGGGTAATCTTG
TAAAGAGATAGATGCGCCTGAGCATTTACA|TGAGTCGACTTTGTAACGGATAGATTTCAA
GGTAATCTTGAATGTACTTCAATAGGGACT|AAACTTCTCCTGGTACACTGAGGTCGGAGT
CAATAGGGACTTTCATACCAAAGCGTACTT|GAGGTCGGAGTAATGAGTCGACTTTGTAAC
GATAGATTTCAACATTGTGCGCTGCTGAGT|GTACGCATAGATATGTCTAAACGATTTAAA
TAACGGATAGATTTCAATACACCTCACTGT|GCTCGTTCACTCGTTGAGTCGACTTTGTAA
TATATCACCAGAATTCGCTCGCGCCTTCTC|GCGCTGAGTCGACTTTGTAACGGATAGATT
CGAATGCGCAGTGGCCACGCAGGGGCTCTG|ATTTCAATACACCTCACTGTCGGCATACGA
TGAAAAGCATAACTGCCGCGAATGCAATTG|GGATAGATTTCAAGTATCAGCGATCACTTC
ATAAGGCTAGTACACCTTAACGCTCGTTCA|GACCCATGAGAATAGCCATCAAATTGTGAG
TTTGTAACGGATAGATTTCAATACACCTCA|TAACGCTCGTTCACTCGTTGAGTCGACTTT
TTTCAACCGATCTCATGATCTACGTACAAA|TCAAAACGGATAGATTTCAATCCGTCAATA
AATGCGCAGTGGCCACGCAGGGGCTCTGAG|TTCAATACACCTCACTGTCGGCATACGAAG
CCGTCAATATTCTGTTGTTGAGTCGACTTT|TGGCAACTGTATAAGGCTAGTACACCTTAA
AGTCGACTTTGTAACGGATAGATTTCAAAC|AATGTACTGCCGTTCCATCTCACATCCACA
GAGTCGACTTTGTAACGGATAGATTTCAAT|AAACGGCCCAGAGCGCATGCGCCATTAACG
ATAACATTGACCCATGAGAATAGCCATCAA|AAACATTGCAGGTTTACAACTGCAGTACTT
TGAGTCGACTTTGTAACGGATAGATTTCAA|CCTGTAAAGGGCAACGAGGCGCTGCTCACG
ACAAGACAGCTGAGTCGACTTTGTAACGGA|CCGACATCACACCCGCAGGCATGTAACACC
ACATTGCAGGTTTACAACTGCAGTACTTAT|CCTTCGCCGAAGCCATTTTATGAGCAACAA
TTTGTAACGGATAGATTTCAAGTATCAGCG|TCTATCCGCCTCTAGTATCAAGTCCTAGAT
AACGGATAGATTTCAATCCGTCAATATTCT|CTGTGAGAGCTCTACTGTGGCAACTGTATA
GGGCAACGAGGCGCTGCTCACGTAAAGAGA|AGCCCTAGGGTTAATTTTTATATGAGTCGA
TTTCAAGAGTCGACTTTGTAACGGATAGAT|CTCACGTAAAGAGATAGATGCGCCTGAGCA
TGCCGTTCCATCTCACATCCACATCGTCAA|AACGGATAGATTTCAAGAGTCGACTTTGTA
CAATTGGGGTGTATAACATTGACCCATGAG|CACTTCTATCCCAAACATTGCAGGTTTACA
TTAGAGACCGGCTGCCGGACTTCAAAAGCA|TCCCCTGAGTCGACTTTGTAACGGATAGAT
TATCAGCGATCACTTCTATCCCAAACATTG|TCCTAGATACTCGCTATTTGTGCGCCTTCG
CCGTTCCATCTCACATCCACATCGTCAAAC|CGGATAGATTTCAAGAGTCGACTTTGTAAC
CAGCTGAGTCGACTTTGTAACGGATAGATT|TCACACCCGCAGGCATGTAACACCACTTAT
AAAGCATAACTGCCGCGAATGCAATTGGGG|TAGATTTCAAGTATCAGCGATCACTTCTAT
AGAATAGCCATCAAATTGTGAGTCGACTTT|CAACTGCAGTACTTATTATCGGCCTCCGCT
CGCAGTGGCCACGCAGGGGCTCTGAGTCGA|ATACACCTCACTGTCGGCATACGAAGCCGT
CTTTGTAACGGATAGATTTCAATACACCTC|TTAACGCTCGTTCACTCGTTGAGTCGACTT
TCCATTATATGAGTCGACTTTGTAACGGAT|TTTCAATAACCAATTTAAAACGACCACAAG
TGTCGGCATACGAAGCCGTGAGTGAGTCGA|TAACGGATAGATTTCAACGCGCTGGTACTA
TGAGTCGACTTTGTAACGGATAGATTTCAA|GTCGACTTTGTAACGGATAGATTTCAAAGT
TACCAAAGCGTACTTGTCTCCTGTAAAGGG|AGTCGACTTTGTAACGGATAGATTTCAAGC
TCATGATCTACGTACAAATGGTCTCCGAAG|GATTTCAATCCGTCAATATTCTGTTGTTGA
TATATGAGTCGACTTTGTAACGGATAGATT|GTTGAGTCGACTTTGTAACGGATAGATTTC
TTAACGTCGCTACCTAACCTGATGCCGACA|GAGGGACGCGGGGTAATCTTGAATGTACTT
CTGAGTCGACTTTGTAACGGATAGATTTCA|TCAAACGGCCCAGAGCGCATGCGCCATTAA
TGGTACTATCGGCGTGTGAAAAGCATAACT|GAGTCGACTTTGTAACGGATAGATTTCAAG
GCTGCTGAGTCGACTTTGTAACGGATAGAT|ACGATTTAAATGCGTCTATCCGCCTCTAGT
GACTTTGTAACGGATAGATTTCAAGAGTCG|AAGGGCAACGAGGCGCTGCTCACGTAAAGA
TTTTATATGAGTCGACTTTGTAACGGATAG|TTTGTTGAGTCGACTTTGTAACGGATAGAT
TTGTGAGTCGACTTTGTAACGGATAGATTT|TTATCGGCCTCCGCTGAGCTCGTACGCATA
GGATAGATTTCAATCCGTCAATATTCTGTT|TGAGAGCTCTACTGTGGCAACTGTATAAGG
GTAACGGATAGATTTCAACGCGCTGGTACT|AGATTTCAACATTGTGCGCTGCTGAGTCGA
TGAGTCGACTTTGTAACGGATAGATTTCAA|GTAATGTACTGCCGTTCCATCTCACATCCA
ACGGCCCAGAGCGCATGCGCCATTAACGTC|ACGGATAGATTTCAAGTGGTTCGAGGGACG
TTGTAACGGATAGATTTCAAGTATCAGCGA|CTATCCGCCTCTAGTATCAAGTCCTAGATA
ATAGATTTCAAACGCGCTGAGTCGACTTTG|TCTCACATCCACATCGTCAAACGGCCCAGA
ACTTTGTAACGGATAGATTTCAACGCGCTG|CGGATAGATTTCAACATTGTGCGCTGCTGA
TAGATTTCAAAACGGATAGATTTCAATCCG|ATTTCAAAGTCTGTGAGAGCTCTACTGTGG
ACAGCTGAGTCGACTTTGTAACGGATAGAT|ATCACACCCGCAGGCATGTAACACCACTTA
CTGAGCATTTACACAATATTTGTCGCGTTT|GGATAGATTTCAACCGATCTCATGATCTAC
GGATAGATTTCAAAACGGATAGATTTCAAT|TAGATTTCAAAGTCTGTGAGAGCTCTACTG
AACGTCGCTACCTAACCTGATGCCGACATC|GGGACGCGGGGTAATCTTGAATGTACTTCA
CGACTTTGTAACGGATAGATTTCAACTGTC|TTAAAACGACCACAAGACAGCTGAGTCGAC
CGTAAAGAGATAGATGCGCCTGAGCATTTA|TATGAGTCGACTTTGTAACGGATAGATTTC
GTCTCCGAAGCATCTGCCCTCCCTCCAAGC|CTGTTGTTGAGTCGACTTTGTAACGGATAG
AATTTTTATATGAGTCGACTTTGTAACGGA|GACTTTGTTGAGTCGACTTTGTAACGGATA
ATCCGTCAATATTCTGTTGTTGAGTCGACT|TGTGGCAACTGTATAAGGCTAGTACACCTT
CTGGTACTATCGGCGTGTGAAAAGCATAAC|TGAGTCGACTTTGTAACGGATAGATTTCAA
CTGCTCACGTAAAGAGATAGATGCGCCTGA|ATTTTTATATGAGTCGACTTTGTAACGGAT
TTTGTAACGGATAGATTTCAACATTGTGCG|GCTGAGCTCGTACGCATAGATATGTCTAAA
CATGAGAATAGCCATCAAATTGTGAGTCGA|TTTACAACTGCAGTACTTATTATCGGCCTC
GAGTCGACTTTGTAACGGATAGATTTCAAA|GGTACTATCGGCGTGTGAAAAGCATAACTG
AAGGGCAACGAGGCGCTGCTCACGTAAAGA|CAAGCCCTAGGGTTAATTTTTATATGAGTC
AGCAAACAGCATATATCACCAGAATTCGCT|AGATTTCAAACGCGCTGAGTCGACTTTGTA
GAGGGACGCGGGGTAATCTTGAATGTACTT|TTGTCGCGTTTAAACTTCTCCTGGTACACT
CGGATAGATTTCAAAACGGATAGATTTCAA|ATAGATTTCAAAGTCTGTGAGAGCTCTACT
CCCTGAGTCGACTTTGTAACGGATAGATTT|TTAGTAATGTACTGCCGTTCCATCTCACAT
GCATATATCACCAGAATTCGCTCGCGCCTT|AACGCGCTGAGTCGACTTTGTAACGGATAG
CTGCAGTACTTATTATCGGCCTCCGCTGAG|TTATGAGCAACAAGACACAGTTCGGTGTCC
TCAATCCGTCAATATTCTGTTGTTGAGTCG|TACTGTGGCAACTGTATAAGGCTAGTACAC
TGTATAACATTGACCCATGAGAATAGCCAT|CCCAAACATTGCAGGTTTACAACTGCAGTA
AAGCCGAATGCGCAGTGGCCACGCAGGGGC|ATAGATTTCAATACACCTCACTGTCGGCAT
GAGTCGACTTTGTTGAGTCGACTTTGTAAC|AAGCCGTGAGTGAGTCGACTTTGTAACGGA
ACTTTGTTGAGTCGACTTTGTAACGGATAG|TGAGTGAGTCGACTTTGTAACGGATAGATT
AGCGTACTTGTCTCCTGTAAAGGGCAACGA|CTTTGTAACGGATAGATTTCAAGCCCTAGG
AGGTCGGAGTAATGAGTCGACTTTGTAACG|ATCTGCCCTCCCTCCAAGCCGAATGCGCAG
CTTTGTAACGGATAGATTTCAACTGTCGTA|AAACGACCACAAGACAGCTGAGTCGACTTT
CTAACCTGATGCCGACATCACACCCGCAGG|TAATCTTGAATGTACTTCAATAGGGACTTT
GCCGTTCCATCTCACATCCACATCGTCAAA|ACGGATAGATTTCAAGAGTCGACTTTGTAA
ATCTCGACTCAGTGTTGGTCCCCTGAGTCG|GTAACGGATAGATTTCAAACTTAGTAATGT
GTTGAGTCGACTTTGTAACGGATAGATTTC|ACTTTGTAACGGATAGATTTCAACATTGTG
AGTCTGTGAGAGCTCTACTGTGGCAACTGT|GCCGCGAATGCAATTGGGGTGTATAACATT
CGACATCACACCCGCAGGCATGTAACACCA|TACTTCAATAGGGACTTTCATACCAAAGCG
AGTCGACTTTGTAACGGATAGATTTCAACG|TGTAACGGATAGATTTCAACATTGTGCGCT
GTAATGAGTCGACTTTGTAACGGATAGATT|TCCCTCCAAGCCGAATGCGCAGTGGCCACG
AGGGTTAATTTTTATATGAGTCGACTTTGT|TGAGTCGACTTTGTTGAGTCGACTTTGTAA
CATATATCACCAGAATTCGCTCGCGCCTTC|ACGCGCTGAGTCGACTTTGTAACGGATAGA
GTCGCTACCTAACCTGATGCCGACATCACA|ACGCGGGGTAATCTTGAATGTACTTCAATA
AGATTTCAAGTGGTTCGAGGGACGCGGGGT|AGCATTTACACAATATTTGTCGCGTTTAAA
CGCGAATGCAATTGGGGTGTATAACATTGA|TCAGCGATCACTTCTATCCCAAACATTGCA
TGAGTCGACTTTGTAACGGATAGATTTCAA|CCAATTTAAAACGACCACAAGACAGCTGAG
TCAATAACCAATTTAAAACGACCACAAGAC|TAACGTCGCTACCTAACCTGATGCCGACAT
CAATAACCAATTTAAAACGACCACAAGACA|AACGTCGCTACCTAACCTGATGCCGACATC
CGCCTGAGCATTTACACAATATTTGTCGCG|AACGGATAGATTTCAACCGATCTCATGATC
TCAATATTCTGTTGTTGAGTCGACTTTGTA|CAACTGTATAAGGCTAGTACACCTTAACGC
CGCATGCGCCATTAACGTCGCTACCTAACC|TCAAGTGGTTCGAGGGACGCGGGGTAATCT
GTTGAGTCGACTTTGTAACGGATAGATTTC|CTCCTGTAAAGGGCAACGAGGCGCTGCTCA
TGAGAGCTCTACTGTGGCAACTGTATAAGG|AATGCAATTGGGGTGTATAACATTGACCCA
TAAAGGGCAACGAGGCGCTGCTCACGTAAA|TTCAAGCCCTAGGGTTAATTTTTATATGAG
GCGTACTTGTCTCCTGTAAAGGGCAACGAG|TTTGTAACGGATAGATTTCAAGCCCTAGGG
TATAACATTGACCCATGAGAATAGCCATCA|CAAACATTGCAGGTTTACAACTGCAGTACT
GACCGGCTGCCGGACTTCAAAAGCAAACAG|TGAGTCGACTTTGTAACGGATAGATTTCAA
TTCAATACACCTCACTGTCGGCATACGAAG|GTTGAGTCGACTTTGTAACGGATAGATTTC
GGCAACGAGGCGCTGCTCACGTAAAGAGAT|GCCCTAGGGTTAATTTTTATATGAGTCGAC
TTTAAACTTCTCCTGGTACACTGAGGTCGG|TACGTACAAATGGTCTCCGAAGCATCTGCC
TTGTAACGGATAGATTTCAACCGATCTCAT|GTAACGGATAGATTTCAAAACGGATAGATT
TCACCAGAATTCGCTCGCGCCTTCTCCATT|TGAGTCGACTTTGTAACGGATAGATTTCAA
TGTGCGCTGCTGAGTCGACTTTGTAACGGA|TCTAAACGATTTAAATGCGTCTATCCGCCT
CGGATAGATTTCAAGTGGTTCGAGGGACGC|GCCTGAGCATTTACACAATATTTGTCGCGT
TCGACTTTGTAACGGATAGATTTCAAACGC|TGTACTGCCGTTCCATCTCACATCCACATC
TGAGTCGACTTTGTAACGGATAGATTTCAA|TTAAATGCGTCTATCCGCCTCTAGTATCAA
CGTAATCTCGACTCAGTGTTGGTCCCCTGA|CTTTGTAACGGATAGATTTCAAACTTAGTA
GAGATAGATGCGCCTGAGCATTTACACAAT|TCGACTTTGTAACGGATAGATTTCAACCGA
CTCCAAGCCGAATGCGCAGTGGCCACGCAG|ACGGATAGATTTCAATACACCTCACTGTCG
CGCCATTAACGTCGCTACCTAACCTGATGC|GGTTCGAGGGACGCGGGGTAATCTTGAATG
AACGCGCTGAGTCGACTTTGTAACGGATAG|ACATCGTCAAACGGCCCAGAGCGCATGCGC
AAGCATAACTGCCGCGAATGCAATTGGGGT|AGATTTCAAGTATCAGCGATCACTTCTATC
ATCTGCCCTCCCTCCAAGCCGAATGCGCAG|TCGACTTTGTAACGGATAGATTTCAATACA
ATTTCAAAACGGATAGATTTCAATCCGTCA|TCAAAGTCTGTGAGAGCTCTACTGTGGCAA
ATAGATTTCAACATTGTGCGCTGCTGAGTC|TACGCATAGATATGTCTAAACGATTTAAAT
ACATTGTGCGCTGCTGAGTCGACTTTGTAA|TATGTCTAAACGATTTAAATGCGTCTATCC
ATCACACCCGCAGGCATGTAACACCACTTA|TCAATAGGGACTTTCATACCAAAGCGTACT
GGGTGTATAACATTGACCCATGAGAATAGC|TATCCCAAACATTGCAGGTTTACAACTGCA
TCCTGTAAAGGGCAACGAGGCGCTGCTCAC|TAGATTTCAAGCCCTAGGGTTAATTTTTAT
AACGGATAGATTTCAAGCCCTAGGGTTAAT|GCAGTGGCCACGCAGGGGCTCTGAGTCGAC
TCAAATTGTGAGTCGACTTTGTAACGGATA|ACTTATTATCGGCCTCCGCTGAGCTCGTAC
CTCGACTCAGTGTTGGTCCCCTGAGTCGAC|AACGGATAGATTTCAAACTTAGTAATGTAC
GAGTCGACTTTGTAACGGATAGATTTCAAA|TCGACTTTGTAACGGATAGATTTCAAAGTC
CAGTGTTGGTCCCCTGAGTCGACTTTGTAA|AGATTTCAAACTTAGTAATGTACTGCCGTT
AGGGCAACGAGGCGCTGCTCACGTAAAGAG|AAGCCCTAGGGTTAATTTTTATATGAGTCG
AGATTTCAAACGCGCTGAGTCGACTTTGTA|TCACATCCACATCGTCAAACGGCCCAGAGC
ACGGATAGATTTCAACGCGCTGGTACTATC|TTTCAACATTGTGCGCTGCTGAGTCGACTT
GGACGCGGGGTAATCTTGAATGTACTTCAA|TCGCGTTTAAACTTCTCCTGGTACACTGAG
TAACGGATAGATTTCAAACTTAGTAATGTA|TAACACCACTTATTTGTTGAGTCGACTTTG
TCTGTTGTTGAGTCGACTTTGTAACGGATA|ATAAGGCTAGTACACCTTAACGCTCGTTCA
CTGATTTTTAGAGACCGGCTGCCGGACTTC|GTGTTGGTCCCCTGAGTCGACTTTGTAACG
TCGAGGGACGCGGGGTAATCTTGAATGTAC|ATTTGTCGCGTTTAAACTTCTCCTGGTACA
ATTTCAATACACCTCACTGTCGGCATACGA|TCGTTGAGTCGACTTTGTAACGGATAGATT
GGATAGATTTCAACGCGCTGGTACTATCGG|TCAACATTGTGCGCTGCTGAGTCGACTTTG
TAGATTTCAACATTGTGCGCTGCTGAGTCG|ACGCATAGATATGTCTAAACGATTTAAATG
ACTCGTTGAGTCGACTTTGTAACGGATAGA|GTCGACTTTGTAACGGATAGATTTCAACAT
GTCGACTTTGTAACGGATAGATTTCAACTG|ATTTAAAACGACCACAAGACAGCTGAGTCG
CCTCCCTCCAAGCCGAATGCGCAGTGGCCA|TTGTAACGGATAGATTTCAATACACCTCAC
AACGGATAGATTTCAAGAGTCGACTTTGTA|CGAGGCGCTGCTCACGTAAAGAGATAGATG
AATACACCTCACTGTCGGCATACGAAGCCG|GAGTCGACTTTGTAACGGATAGATTTCAAC
GTAACGGATAGATTTCAATACACCTCACTG|CGCTCGTTCACTCGTTGAGTCGACTTTGTA
CTCGTTGAGTCGACTTTGTAACGGATAGAT|TCGACTTTGTAACGGATAGATTTCAACATT
TATTTGTCGCGTTTAAACTTCTCCTGGTAC|ATCTCATGATCTACGTACAAATGGTCTCCG
TTGTAACGGATAGATTTCAAGTGGTTCGAG|AGATGCGCCTGAGCATTTACACAATATTTG
TTGAATGTACTTCAATAGGGACTTTCATAC|TCCTGGTACACTGAGGTCGGAGTAATGAGT
AAGGCTAGTACACCTTAACGCTCGTTCACT|CCCATGAGAATAGCCATCAAATTGTGAGTC
CGAGGGACGCGGGGTAATCTTGAATGTACT|TTTGTCGCGTTTAAACTTCTCCTGGTACAC
ACGACCACAAGACAGCTGAGTCGACTTTGT|CTGATGCCGACATCACACCCGCAGGCATGT
TTTCAAAACGGATAGATTTCAATCCGTCAA|CAAAGTCTGTGAGAGCTCTACTGTGGCAAC
CCTGTAAAGGGCAACGAGGCGCTGCTCACG|AGATTTCAAGCCCTAGGGTTAATTTTTATA
GACTTTGTAACGGATAGATTTCAAGCCCTA|CCGAATGCGCAGTGGCCACGCAGGGGCTCT
ACTTTGTAACGGATAGATTTCAACTGTCGT|AAAACGACCACAAGACAGCTGAGTCGACTT
CCGTGAGTGAGTCGACTTTGTAACGGATAG|AACGCGCTGGTACTATCGGCGTGTGAAAAG
AACGGATAGATTTCAAACGCGCTGAGTCGA|TTCCATCTCACATCCACATCGTCAAACGGC
ATGCGCCTGAGCATTTACACAATATTTGTC|TGTAACGGATAGATTTCAACCGATCTCATG
TGATTTTTAGAGACCGGCTGCCGGACTTCA|TGTTGGTCCCCTGAGTCGACTTTGTAACGG
TCGTTCACTCGTTGAGTCGACTTTGTAACG|TTGTGAGTCGACTTTGTAACGGATAGATTT
TTATATGAGTCGACTTTGTAACGGATAGAT|TGTTGAGTCGACTTTGTAACGGATAGATTT
GCATTTACACAATATTTGTCGCGTTTAAAC|AGATTTCAACCGATCTCATGATCTACGTAC
TCGCGCCTTCTCCATTATATGAGTCGACTT|AACGGATAGATTTCAATAACCAATTTAAAA
CAAAGTCTGTGAGAGCTCTACTGTGGCAAC|ACTGCCGCGAATGCAATTGGGGTGTATAAC
CGGATAGATTTCAATACACCTCACTGTCGG|CGTTCACTCGTTGAGTCGACTTTGTAACGG
CGGATAGATTTCAACTGTCGTAATCTCGAC|ACAAGACAGCTGAGTCGACTTTGTAACGGA
CCAAGCCGAATGCGCAGTGGCCACGCAGGG|GGATAGATTTCAATACACCTCACTGTCGGC
CTGAGTCGACTTTGTAACGGATAGATTTCA|AGTAATGTACTGCCGTTCCATCTCACATCC
CTACGTACAAATGGTCTCCGAAGCATCTGC|ATCCGTCAATATTCTGTTGTTGAGTCGACT
GCTACCTAACCTGATGCCGACATCACACCC|CGGGGTAATCTTGAATGTACTTCAATAGGG
GATAGATTTCAAGAGTCGACTTTGTAACGG|GCGCTGCTCACGTAAAGAGATAGATGCGCC
CACTCGTTGAGTCGACTTTGTAACGGATAG|AGTCGACTTTGTAACGGATAGATTTCAACA
CGCAGGGGCTCTGAGTCGACTTTGTTGAGT|TGTCGGCATACGAAGCCGTGAGTGAGTCGA
AAGTGGTTCGAGGGACGCGGGGTAATCTTG|ACACAATATTTGTCGCGTTTAAACTTCTCC
CTTTGTAACGGATAGATTTCAACATTGTGC|CGCTGAGCTCGTACGCATAGATATGTCTAA
GCATGCGCCATTAACGTCGCTACCTAACCT|CAAGTGGTTCGAGGGACGCGGGGTAATCTT
TTCAAAAGCAAACAGCATATATCACCAGAA|ACGGATAGATTTCAAACGCGCTGAGTCGAC
GCTCACGTAAAGAGATAGATGCGCCTGAGC|TTTTATATGAGTCGACTTTGTAACGGATAG
GTTGTTGAGTCGACTTTGTAACGGATAGAT|AGGCTAGTACACCTTAACGCTCGTTCACTC
GTAATCTTGAATGTACTTCAATAGGGACTT|AACTTCTCCTGGTACACTGAGGTCGGAGTA
CGAAGCCGTGAGTGAGTCGACTTTGTAACG|ATTTCAACGCGCTGGTACTATCGGCGTGTG
GCGCTGCTGAGTCGACTTTGTAACGGATAG|AAACGATTTAAATGCGTCTATCCGCCTCTA
TTCACTCGTTGAGTCGACTTTGTAACGGAT|TGAGTCGACTTTGTAACGGATAGATTTCAA
GATAGATTTCAATAACCAATTTAAAACGAC|TGCGCCATTAACGTCGCTACCTAACCTGAT
CTGAGTCGACTTTGTTGAGTCGACTTTGTA|CGAAGCCGTGAGTGAGTCGACTTTGTAACG
TTTGTAACGGATAGATTTCAAACTTAGTAA|CATGTAACACCACTTATTTGTTGAGTCGAC
CAGAGCGCATGCGCCATTAACGTCGCTACC|AGATTTCAAGTGGTTCGAGGGACGCGGGGT
GATAGATTTCAATCCGTCAATATTCTGTTG|GAGAGCTCTACTGTGGCAACTGTATAAGGC
ACGGATAGATTTCAAAACGGATAGATTTCA|GATAGATTTCAAAGTCTGTGAGAGCTCTAC
TCTCACATCCACATCGTCAAACGGCCCAGA|TTTCAAGAGTCGACTTTGTAACGGATAGAT
ACGGATAGATTTCAAAGTCTGTGAGAGCTC|GTGAAAAGCATAACTGCCGCGAATGCAATT
CCTCCAAGCCGAATGCGCAGTGGCCACGCA|AACGGATAGATTTCAATACACCTCACTGTC
ACGTACAAATGGTCTCCGAAGCATCTGCCC|CCGTCAATATTCTGTTGTTGAGTCGACTTT
ACGGATAGATTTCAAGTATCAGCGATCACT|CGCCTCTAGTATCAAGTCCTAGATACTCGC
AAGTATCAGCGATCACTTCTATCCCAAACA|AAGTCCTAGATACTCGCTATTTGTGCGCCT
GGAGTGTGTTCTGATTTTTAGAGACCGGCT|TCTCGACTCAGTGTTGGTCCCCTGAGTCGA
GGCTGCCGGACTTCAAAAGCAAACAGCATA|TCGACTTTGTAACGGATAGATTTCAAACGC
GATTTCAAAACGGATAGATTTCAATCCGTC|TTCAAAGTCTGTGAGAGCTCTACTGTGGCA
CTTGTCTCCTGTAAAGGGCAACGAGGCGCT|AACGGATAGATTTCAAGCCCTAGGGTTAAT
AAAAGCAAACAGCATATATCACCAGAATTC|GATAGATTTCAAACGCGCTGAGTCGACTTT
CATCTCACATCCACATCGTCAAACGGCCCA|GATTTCAAGAGTCGACTTTGTAACGGATAG
GGATAGATTTCAAGTATCAGCGATCACTTC|CCTCTAGTATCAAGTCCTAGATACTCGCTA
ATTTTTATATGAGTCGACTTTGTAACGGAT|ACTTTGTTGAGTCGACTTTGTAACGGATAG
ATAGATTTCAATCCGTCAATATTCTGTTGT|AGAGCTCTACTGTGGCAACTGTATAAGGCT
CGGCCCAGAGCGCATGCGCCATTAACGTCG|CGGATAGATTTCAAGTGGTTCGAGGGACGC
CCAGAGCGCATGCGCCATTAACGTCGCTAC|TAGATTTCAAGTGGTTCGAGGGACGCGGGG
CTTATTTGTTGAGTCGACTTTGTAACGGAT|TACTTGTCTCCTGTAAAGGGCAACGAGGCG
TTTCAATACACCTCACTGTCGGCATACGAA|CGTTGAGTCGACTTTGTAACGGATAGATTT
GCAGTGGCCACGCAGGGGCTCTGAGTCGAC|TACACCTCACTGTCGGCATACGAAGCCGTG
ATTTAAAACGACCACAAGACAGCTGAGTCG|ACCTAACCTGATGCCGACATCACACCCGCA
GTCTCCTGTAAAGGGCAACGAGGCGCTGCT|GGATAGATTTCAAGCCCTAGGGTTAATTTT
TAACGGATAGATTTCAACGCGCTGGTACTA|GATTTCAACATTGTGCGCTGCTGAGTCGAC
CCACAAGACAGCTGAGTCGACTTTGTAACG|TGCCGACATCACACCCGCAGGCATGTAACA
ACCTTAACGCTCGTTCACTCGTTGAGTCGA|AGCCATCAAATTGTGAGTCGACTTTGTAAC
ATGTAACACCACTTATTTGTTGAGTCGACT|ATACCAAAGCGTACTTGTCTCCTGTAAAGG
CTTCTATCCCAAACATTGCAGGTTTACAAC|GCTATTTGTGCGCCTTCGCCGAAGCCATTT
AGTCGACTTTGTAACGGATAGATTTCAAAG|GTACTATCGGCGTGTGAAAAGCATAACTGC
AACGCTCGTTCACTCGTTGAGTCGACTTTG|TCAAATTGTGAGTCGACTTTGTAACGGATA
CTCACTGTCGGCATACGAAGCCGTGAGTGA|CTTTGTAACGGATAGATTTCAACGCGCTGG
CTGTATAAGGCTAGTACACCTTAACGCTCG|CATTGACCCATGAGAATAGCCATCAAATTG
ACTTATTTGTTGAGTCGACTTTGTAACGGA|GTACTTGTCTCCTGTAAAGGGCAACGAGGC
CAACATTGTGCGCTGCTGAGTCGACTTTGT|GATATGTCTAAACGATTTAAATGCGTCTAT
ACGTCGCTACCTAACCTGATGCCGACATCA|GGACGCGGGGTAATCTTGAATGTACTTCAA
TCCTGGTACACTGAGGTCGGAGTAATGAGT|TGGTCTCCGAAGCATCTGCCCTCCCTCCAA
CGGATAGATTTCAATCCGTCAATATTCTGT|GTGAGAGCTCTACTGTGGCAACTGTATAAG
CTATTTGGAGTGTGTTCTGATTTTTAGAGA|TCGTAATCTCGACTCAGTGTTGGTCCCCTG
AATGTACTGCCGTTCCATCTCACATCCACA|ACTTTGTAACGGATAGATTTCAAGAGTCGA
GATTTCAAAGTCTGTGAGAGCTCTACTGTG|GCATAACTGCCGCGAATGCAATTGGGGTGT
GTGGCCACGCAGGGGCTCTGAGTCGACTTT|ACCTCACTGTCGGCATACGAAGCCGTGAGT
CGATCTCATGATCTACGTACAAATGGTCTC|GGATAGATTTCAATCCGTCAATATTCTGTT
GAGACCGGCTGCCGGACTTCAAAAGCAAAC|CCTGAGTCGACTTTGTAACGGATAGATTTC
GTGAAAAGCATAACTGCCGCGAATGCAATT|CGGATAGATTTCAAGTATCAGCGATCACTT
GTCAAACGGCCCAGAGCGCATGCGCCATTA|TTGTAACGGATAGATTTCAAGTGGTTCGAG
TTGTCTCCTGTAAAGGGCAACGAGGCGCTG|ACGGATAGATTTCAAGCCCTAGGGTTAATT
AGAGCTCTACTGTGGCAACTGTATAAGGCT|TGCAATTGGGGTGTATAACATTGACCCATG
CTCTGAGTCGACTTTGTTGAGTCGACTTTG|TACGAAGCCGTGAGTGAGTCGACTTTGTAA
CACATCCACATCGTCAAACGGCCCAGAGCG|CAAGAGTCGACTTTGTAACGGATAGATTTC
CGCTCGCGCCTTCTCCATTATATGAGTCGA|TGTAACGGATAGATTTCAATAACCAATTTA
TCCAAGCCGAATGCGCAGTGGCCACGCAGG|CGGATAGATTTCAATACACCTCACTGTCGG
GTGCGCTGCTGAGTCGACTTTGTAACGGAT|CTAAACGATTTAAATGCGTCTATCCGCCTC
GCTGAGTCGACTTTGTAACGGATAGATTTC|ATTTAAATGCGTCTATCCGCCTCTAGTATC
TTTCAATCCGTCAATATTCTGTTGTTGAGT|TCTACTGTGGCAACTGTATAAGGCTAGTAC
TCGACTTTGTAACGGATAGATTTCAAAACG|ACTTTGTAACGGATAGATTTCAAAGTCTGT
GGGTAATCTTGAATGTACTTCAATAGGGAC|TAAACTTCTCCTGGTACACTGAGGTCGGAG
GTTGAGTCGACTTTGTAACGGATAGATTTC|CTAGTACACCTTAACGCTCGTTCACTCGTT
CTTTGTAACGGATAGATTTCAAAGTCTGTG|TCGGCGTGTGAAAAGCATAACTGCCGCGAA
TCAAAGTCTGTGAGAGCTCTACTGTGGCAA|AACTGCCGCGAATGCAATTGGGGTGTATAA
AACTGCCGCGAATGCAATTGGGGTGTATAA|CAAGTATCAGCGATCACTTCTATCCCAAAC
CAAAACGGATAGATTTCAATCCGTCAATAT|AGTCTGTGAGAGCTCTACTGTGGCAACTGT
CGCGCTGGTACTATCGGCGTGTGAAAAGCA|CTGCTGAGTCGACTTTGTAACGGATAGATT
GGTACACTGAGGTCGGAGTAATGAGTCGAC|CTCCGAAGCATCTGCCCTCCCTCCAAGCCG
GCGTTTAAACTTCTCCTGGTACACTGAGGT|ATCTACGTACAAATGGTCTCCGAAGCATCT
TCCCTCCAAGCCGAATGCGCAGTGGCCACG|GTAACGGATAGATTTCAATACACCTCACTG
CATTTACACAATATTTGTCGCGTTTAAACT|GATTTCAACCGATCTCATGATCTACGTACA
AGATGCGCCTGAGCATTTACACAATATTTG|TTTGTAACGGATAGATTTCAACCGATCTCA
CATACGAAGCCGTGAGTGAGTCGACTTTGT|ATAGATTTCAACGCGCTGGTACTATCGGCG
TTTGTTGAGTCGACTTTGTAACGGATAGAT|AGTGAGTCGACTTTGTAACGGATAGATTTC
GTCGACTTTGTAACGGATAGATTTCAAAGT|TACTATCGGCGTGTGAAAAGCATAACTGCC
TCTCCATTATATGAGTCGACTTTGTAACGG|GATTTCAATAACCAATTTAAAACGACCACA
TCTGCCCTCCCTCCAAGCCGAATGCGCAGT|CGACTTTGTAACGGATAGATTTCAATACAC
TCACACCCGCAGGCATGTAACACCACTTAT|CAATAGGGACTTTCATACCAAAGCGTACTT
TTTGTAACGGATAGATTTCAAAACGGATAG|GTAACGGATAGATTTCAAAGTCTGTGAGAG
CTACTGTGGCAACTGTATAAGGCTAGTACA|TGGGGTGTATAACATTGACCCATGAGAATA
ATTTCAAGTGGTTCGAGGGACGCGGGGTAA|CATTTACACAATATTTGTCGCGTTTAAACT
CACAAGACAGCTGAGTCGACTTTGTAACGG|GCCGACATCACACCCGCAGGCATGTAACAC
CCTGAGTCGACTTTGTAACGGATAGATTTC|TAGTAATGTACTGCCGTTCCATCTCACATC
GAGAGCTCTACTGTGGCAACTGTATAAGGC|ATGCAATTGGGGTGTATAACATTGACCCAT
ACATTGACCCATGAGAATAGCCATCAAATT|CATTGCAGGTTTACAACTGCAGTACTTATT
GAAGCCGTGAGTGAGTCGACTTTGTAACGG|TTTCAACGCGCTGGTACTATCGGCGTGTGA
GTGAGAGCTCTACTGTGGCAACTGTATAAG|GAATGCAATTGGGGTGTATAACATTGACCC
CTCCTGGTACACTGAGGTCGGAGTAATGAG|ATGGTCTCCGAAGCATCTGCCCTCCCTCCA
CTTTGTAACGGATAGATTTCAAAACGGATA|TGTAACGGATAGATTTCAAAGTCTGTGAGA
TTGTAACGGATAGATTTCAACATTGTGCGC|CTGAGCTCGTACGCATAGATATGTCTAAAC
TGAGTCGACTTTGTAACGGATAGATTTCAA|TCCAAGCCGAATGCGCAGTGGCCACGCAGG
CACTGTCGGCATACGAAGCCGTGAGTGAGT|TTGTAACGGATAGATTTCAACGCGCTGGTA